Post_Date,Check,Description,Debit,Credit,Status,Balance,Classification
2021-11-30,,Withdrawal Acct Svc Charge,10,,Posted,6915.42,Uncategorized
2021-11-30,,"In the amount $9,205.09 INTUIT PAYROLL S",31,,Posted,6925.42,Business Services
2021-11-30,,TYPE: EPS ID: H03900 CO: JACK HENRY &amp; ASC,46.74,,Posted,6956.42,Uncategorized
2021-11-30,,TYPE: DEPOSIT ID: C592126793 CO: MERCHANT BANKCD,1.04,,Posted,7003.16,Uncategorized
2021-11-30,,MORRELL PRINTING SOLUTION 303-6654210 CO Date 11/29/21 24559301333900010000202 Card 5089,73.15,,Posted,7004.2,Printing
2021-11-29,,CORALTREE-QBOX 408-448-7269 CA Date 11/29/21 24492151333743530408102 Card 5089,12,,Posted,7077.35,Charity
2021-11-29,,TYPE: DEPOSIT ID: C592126793 CO: MERCHANT BANKCD,,533.5,Posted,7089.35,Income
2021-11-29,,TYPE: DEPOSIT ID: C592126793 CO: MERCHANT BANKCD,,419.21,Posted,6555.85,Income
2021-11-29,,TYPE: DEPOSIT ID: C592126793 CO: MERCHANT BANKCD,,281.9,Posted,6136.64,Income
2021-11-27,,CANVA* I03252-17145756 HTTPSCANVA.CO DE Card 5089,12.99,,Posted,5854.74,Shopping
2021-11-27,,COMCAST CABLE COMM 800-COMCAST CO Card 5089,190.29,,Posted,5867.73,Utilities
2021-11-26,,ZOOM.US 888-799-9666 WWW.ZOOM.US CA Date 11/26/21 24011341330000036036958 Card 5089,32.53,,Posted,6058.02,Business Services
2021-11-26,2470,Check 2470,60,,Posted,6090.55,Check
2021-11-26,,TYPE: DEPOSIT ID: C592126793 CO: MERCHANT BANKCD,1.54,,Posted,6150.55,Uncategorized
2021-11-26,,TYPE: DEPOSIT ID: C592126793 CO: MERCHANT BANKCD,,518.96,Posted,6152.09,Income
2021-11-24,,TYPE: DEPOSIT ID: C592126793 CO: MERCHANT BANKCD,,439.01,Posted,5633.13,Income
2021-11-23,,TYPE: PAYMENT ID: CITICARDAP CO: CITI AUTOPAY,302.3,,Posted,5194.12,Credit Card Payment
2021-11-23,,TYPE: DEPOSIT ID: C592126793 CO: MERCHANT BANKCD,165.52,,Posted,5496.42,Uncategorized
2021-11-23,,TYPE: Settlement ID: 9000904746 CO: VISION QUEST MAR,,130,Posted,5661.94,Uncategorized
2021-11-23,,TYPE: COMB. DEP. ID: 7300604847 CO: 5/3 BANKCARD SYS,,86.74,Posted,5531.94,Income
2021-11-22,,TYPE: TaxPaymnt ID: T846000537 CO: Dept. of Revenue,31.06,,Posted,5445.2,State Tax
2021-11-22,,TYPE: DEPOSIT ID: C592126793 CO: MERCHANT BANKCD,,1060.91,Posted,5476.26,Income
2021-11-22,,TYPE: DEPOSIT ID: C592126793 CO: MERCHANT BANKCD,,315.45,Posted,4415.35,Income
2021-11-22,,TYPE: DEPOSIT ID: C592126793 CO: MERCHANT BANKCD,,135.71,Posted,4099.9,Income
2021-11-21,,ABC*Anytime Fitness 888-8279262 CO Card 5089,32.3,,Posted,3964.19,Gym
2021-11-20,,CEN*CENTURY MA 800-626-2787 OK Date 11/20/21 24692161324100454889239 Card 5089,381.91,,Posted,3996.49,Shopping
2021-11-19,,TYPE: Settlement ID: 9000904746 CO: VISION QUEST MAR,,1176,Posted,4378.4,Uncategorized
2021-11-19,,TYPE: DEPOSIT ID: C592126793 CO: MERCHANT BANKCD,,136.23,Posted,3202.4,Income
2021-11-18,,TYPE: Settlement ID: 9000904746 CO: VISION QUEST MAR,,148,Posted,3066.17,Uncategorized
2021-11-18,,TYPE: DEPOSIT ID: C592126793 CO: MERCHANT BANKCD,,138.84,Posted,2918.17,Income
2021-11-18,,TYPE: COMB. DEP. ID: 7300604847 CO: 5/3 BANKCARD SYS,,34.17,Posted,2779.33,Income
2021-11-17,,TYPE: DEPOSIT ID: C592126793 CO: MERCHANT BANKCD,,144.76,Posted,2745.16,Income
2021-11-16,2491,Check 2491,150,,Posted,2600.4,Check
2021-11-16,2482,Check 2482,68.27,,Posted,2750.4,Check
2021-11-16,,KICKSITE 913-681-9949 KS Date 11/16/21 24055221320200832505254 Card 5089,149,,Posted,2818.67,Charity
2021-11-16,,TYPE: DEPOSIT ID: C592126793 CO: MERCHANT BANKCD,,676.95,Posted,2967.67,Income
2021-11-16,,TYPE: Settlement ID: 9000904746 CO: VISION QUEST MAR,,459,Posted,2290.72,Uncategorized
2021-11-15,,TYPE: USATAXPYMT ID: 3387702000 CO: IRS,2499.63,,Posted,1831.72,Federal Tax
2021-11-15,,TYPE: TaxPaymnt ID: T846000537 CO: Dept. of Revenue,429,,Posted,4331.35,State Tax
2021-11-15,,TYPE: DEPOSIT ID: C592126793 CO: MERCHANT BANKCD,1.04,,Posted,4760.35,Uncategorized
2021-11-15,,TYPE: DEPOSIT ID: C592126793 CO: MERCHANT BANKCD,1.04,,Posted,4761.39,Uncategorized
2021-11-15,,TYPE: DEPOSIT ID: C592126793 CO: MERCHANT BANKCD,,589.82,Posted,4762.43,Income
2021-11-15,,TYPE: COMB. DEP. ID: 7300604847 CO: 5/3 BANKCARD SYS,,119.29,Posted,4172.61,Income
2021-11-15,,SPOTIFY 877-778-1161 NY Card 5089,10.84,,Posted,4053.32,Music
2021-11-13,,ABC*Anytime Fitness 888-8279262 CO Card 5089,45,,Posted,4064.16,Gym
2021-11-12,,TYPE: XCELENERGY ID: 5840296600 CO: XCEL ENERGY-PSCO,258.88,,Posted,4109.16,Utilities
2021-11-12,,TYPE: DEPOSIT ID: C592126793 CO: MERCHANT BANKCD,,448.11,Posted,4368.04,Income
2021-11-12,,TYPE: Settlement ID: 9000904746 CO: VISION QUEST MAR,,429,Posted,3919.93,Uncategorized
2021-11-12,,TYPE: DEPOSIT ID: C592126793 CO: MERCHANT BANKCD,,247.3,Posted,3490.93,Income
2021-11-12,,DNH*GODADDY.COM https://www.g AZ Card 5089,71.88,,Posted,3243.63,Domain Names
2021-11-10,,TYPE: DEPOSIT ID: C592126793 CO: MERCHANT BANKCD,,266.58,Posted,3315.51,Income
2021-11-10,,SMORE.COM WWW.SMORE.COM PA Card 5089,29,,Posted,3048.93,Electronics &amp; Software
2021-11-09,,TYPE: DEPOSIT ID: C592126793 CO: MERCHANT BANKCD,,295.78,Posted,3077.93,Income
2021-11-09,,TYPE: Settlement ID: 9000904746 CO: VISION QUEST MAR,,145,Posted,2782.15,Uncategorized
2021-11-09,,TYPE: COMB. DEP. ID: 7300604847 CO: 5/3 BANKCARD SYS,,25,Posted,2637.15,Income
2021-11-08,2484,Check 2484,188.67,,Posted,2612.15,Check
2021-11-08,,TYPE: DEPOSIT ID: C592126793 CO: MERCHANT BANKCD,1.57,,Posted,2800.82,Uncategorized
2021-11-08,,TYPE: DEPOSIT ID: C592126793 CO: MERCHANT BANKCD,,689.36,Posted,2802.39,Income
2021-11-08,,TYPE: TRANSFER ID: PAYPALSD11 CO: PAYPAL,,371.98,Posted,2113.03,Transfer
2021-11-08,,TYPE: DEPOSIT ID: C592126793 CO: MERCHANT BANKCD,,277.15,Posted,1741.05,Income
2021-11-08,,TYPE: COMB. DEP. ID: 7300604847 CO: 5/3 BANKCARD SYS,,10,Posted,1463.9,Income
2021-11-05,,TYPE: Rent ID: 116943300A CO: Amterre Lincoln,5983.43,,Posted,1453.9,Transfer
2021-11-05,,TYPE: BILLNG ID: 7300604847 CO: VANTIV_INTG_PYMT,241.35,,Posted,7437.33,Home
2021-11-05,,TYPE: Settlement ID: 9000904746 CO: VISION QUEST MAR,,562,Posted,7678.68,Uncategorized
2021-11-05,,TYPE: DEPOSIT ID: C592126793 CO: MERCHANT BANKCD,,146.84,Posted,7116.68,Income
2021-11-05,,TYPE: COMB. DEP. ID: 7300604847 CO: 5/3 BANKCARD SYS,,30,Posted,6969.84,Income
2021-11-04,2483,Check 2483,352.5,,Posted,6939.84,Check
2021-11-04,,TYPE: PURCHASE ID: 9000098054 CO: City of Lafayett,21.95,,Posted,7292.34,Utilities
2021-11-04,,TYPE: DEPOSIT ID: C592126793 CO: MERCHANT BANKCD,,425,Posted,7314.29,Income
2021-11-03,,TYPE: DEPOSIT ID: C592126793 CO: MERCHANT BANKCD,98.73,,Posted,6889.29,Uncategorized
2021-11-03,,TYPE: Settlement ID: 9000904746 CO: VISION QUEST MAR,,130.5,Posted,6988.02,Uncategorized
2021-11-02,,TYPE: PRM PYMT ID: 9437678001 CO: COLO UI ER SV,81.48,,Posted,6857.52,Uncategorized
2021-11-02,,TYPE: DEPOSIT ID: C592126793 CO: MERCHANT BANKCD,,1125.06,Posted,6939,Income
2021-11-02,,CEN*CENTURY MA 800-626-2787 OK Date 11/02/21 24692161306100757779253 Card 5089,70.78,,Posted,5813.94,Shopping
2021-11-01,,CALENDLY HTTPSCALENDLY GA Date 11/01/21 24011341305000011440069 Card 5089,15,,Posted,5884.72,Electronics &amp; Software
2021-11-01,,TYPE: DEPOSIT ID: C592126793 CO: MERCHANT BANKCD,1.04,,Posted,5899.72,Uncategorized
2021-11-01,,TYPE: DEPOSIT ID: C592126793 CO: MERCHANT BANKCD,1.04,,Posted,5900.76,Uncategorized
2021-11-01,,TYPE: COMB. DEP. ID: 7300604847 CO: 5/3 BANKCARD SYS,,16.81,Posted,5901.8,Income
2021-10-31,,Withdrawal Acct Svc Charge,10,,Posted,5884.99,Uncategorized
2021-10-29,,CORALTREE-QBOX 408-448-7269 CA Date 10/29/21 24492151302745997255196 Card 5089,12,,Posted,5894.99,Charity
2021-10-29,,TYPE: QUICKBOOKS ID: 1722616679 CO: INTUIT PAYROLL S,7075.4,,Posted,5906.99,Business Services
2021-10-29,,TYPE: DEPOSIT ID: C592126793 CO: MERCHANT BANKCD,,430.32,Posted,12982.39,Income
2021-10-29,,TYPE: TRANSFER ID: PAYPALSD11 CO: PAYPAL,,249.92,Posted,12552.07,Transfer
2021-10-29,,TYPE: Settlement ID: 9000904746 CO: VISION QUEST MAR,,155,Posted,12302.15,Uncategorized
2021-10-29,,TYPE: COMB. DEP. ID: 7300604847 CO: 5/3 BANKCARD SYS,,54.24,Posted,12147.15,Income
2021-10-28,2488,Check 2488,210,,Posted,12092.91,Check
2021-10-28,,TYPE: DEPOSIT ID: C592126793 CO: MERCHANT BANKCD,,419.21,Posted,12302.91,Income
2021-10-28,,TYPE: COMB. DEP. ID: 7300604847 CO: 5/3 BANKCARD SYS,,335.09,Posted,11883.7,Income
2021-10-27,,CANVA* I03221-26547480 HTTPSCANVA.CO DE Card 5089,12.99,,Posted,11548.61,Shopping
2021-10-27,,TYPE: DEPOSIT ID: C592126793 CO: MERCHANT BANKCD,,533.5,Posted,11561.6,Income
2021-10-27,,ZOOM.US 888-799-9666 WWW.ZOOM.US CA Card 5089,32.53,,Posted,11028.1,Business Services
2021-10-26,,TYPE: USATAXPYMT ID: 3387702000 CO: IRS,2588.71,,Posted,11060.63,Federal Tax
2021-10-26,,TYPE: TaxPaymnt ID: T846000537 CO: Dept. of Revenue,436,,Posted,13649.34,State Tax
2021-10-26,,TYPE: DEPOSIT ID: C592126793 CO: MERCHANT BANKCD,,518.96,Posted,14085.34,Income
2021-10-26,,CEN*CENTURY MA 800-626-2787 OK Date 10/26/21 24692161299100345102223 Card 5089,403.08,,Posted,13566.38,Shopping
2021-10-25,2478,Check 2478,177.02,,Posted,13969.46,Check
2021-10-25,,Deposit Link24 T:9CFJ314NLS2-01,,330,Posted,14146.48,Transfer
2021-10-25,,TYPE: PAYMENT ID: CITICARDAP CO: CITI AUTOPAY,302.95,,Posted,13816.48,Credit Card Payment
2021-10-25,,TYPE: DEPOSIT ID: C592126793 CO: MERCHANT BANKCD,0.52,,Posted,14119.43,Uncategorized
2021-10-25,,TYPE: DEPOSIT ID: C592126793 CO: MERCHANT BANKCD,0.52,,Posted,14119.95,Uncategorized
2021-10-25,,TYPE: DEPOSIT ID: C592126793 CO: MERCHANT BANKCD,,437.97,Posted,14120.47,Income
2021-10-25,,TYPE: COMB. DEP. ID: 7300604847 CO: 5/3 BANKCARD SYS,,54.24,Posted,13682.5,Income
2021-10-24,,COMCAST CABLE COMM 800-COMCAST CO Card 5089,190.4,,Posted,13628.26,Utilities
2021-10-22,,TYPE: COMB. DEP. ID: 7300604847 CO: 5/3 BANKCARD SYS,,376.52,Posted,13818.66,Income
2021-10-22,,TYPE: DEPOSIT ID: C592126793 CO: MERCHANT BANKCD,,136.75,Posted,13442.14,Income
2021-10-21,,TYPE: DEPOSIT ID: C592126793 CO: MERCHANT BANKCD,,902.92,Posted,13305.39,Income
2021-10-21,,TYPE: Settlement ID: 9000904746 CO: VISION QUEST MAR,,630,Posted,12402.47,Uncategorized
2021-10-21,,ABC*Anytime Fitness 888-8279262 CO Card 5089,20,,Posted,11772.47,Gym
2021-10-21,,ABC*Anytime Fitness 888-8279262 CO Card 5089,32.3,,Posted,11792.47,Gym
2021-10-20,,TYPE: TaxPaymnt ID: T846000537 CO: Dept. of Revenue,89.19,,Posted,11824.77,State Tax
2021-10-20,,TYPE: DEPOSIT ID: C592126793 CO: MERCHANT BANKCD,0.52,,Posted,11913.96,Uncategorized
2021-10-20,,TYPE: Settlement ID: 9000904746 CO: VISION QUEST MAR,,447,Posted,11914.48,Uncategorized
2021-10-20,,CEN*CENTURY MA 800-626-2787 OK Date 10/20/21 24692161293100720529681 Card 5089,25.29,,Posted,11467.48,Shopping
2021-10-19,,TYPE: Settlement ID: 9000904746 CO: VISION QUEST MAR,,264,Posted,11492.77,Uncategorized
2021-10-19,,TYPE: DEPOSIT ID: C592126793 CO: MERCHANT BANKCD,,138.32,Posted,11228.77,Income
2021-10-18,,TYPE: DEPOSIT ID: C592126793 CO: MERCHANT BANKCD,5.74,,Posted,11090.45,Uncategorized
2021-10-18,,TYPE: TRANSFER ID: PAYPALSD11 CO: PAYPAL,,1621.55,Posted,11096.19,Transfer
2021-10-18,,TYPE: DEPOSIT ID: C592126793 CO: MERCHANT BANKCD,,772.7,Posted,9474.64,Income
2021-10-18,,TYPE: Settlement ID: 9000904746 CO: VISION QUEST MAR,,320,Posted,8701.94,Uncategorized
2021-10-18,,TYPE: DEPOSIT ID: C592126793 CO: MERCHANT BANKCD,,138.32,Posted,8381.94,Income
2021-10-18,,TYPE: TRANSFER ID: PAYPALSD11 CO: PAYPAL,,70.92,Posted,8243.62,Transfer
2021-10-18,,TYPE: COMB. DEP. ID: 7300604847 CO: 5/3 BANKCARD SYS,,45.96,Posted,8172.7,Income
2021-10-18,,TYPE: COMB. DEP. ID: 7300604847 CO: 5/3 BANKCARD SYS,,25.76,Posted,8126.74,Income
2021-10-16,,KICKSITE 913-681-9949 KS Date 10/16/21 24055221289200832505246 Card 5089,149,,Posted,8100.98,Charity
2021-10-16,,UNITED STATES JUDO ASSOCI 877-4113409 NY Date 10/15/21 24118591289014973507668 Card 5089,60,,Posted,8249.98,Uncategorized
2021-10-16,,UNITED STATES JUDO ASSOCI 877-4113409 NY Date 10/15/21 24118591289014973507593 Card 5089,35,,Posted,8309.98,Uncategorized
2021-10-16,,UNITED STATES JUDO ASSOCI 877-4113409 NY Date 10/15/21 24118591289014973507601 Card 5089,35,,Posted,8344.98,Uncategorized
2021-10-16,,SPOTIFY 877-778-1161 NY Card 5089,10.84,,Posted,8379.98,Music
2021-10-16,,ABC*Anytime Fitness 888-8279262 CO Card 5089,22,,Posted,8390.82,Gym
2021-10-15,,TYPE: DEPOSIT ID: C592126793 CO: MERCHANT BANKCD,,275.13,Posted,8412.82,Income
2021-10-14,,TYPE: PURCHASE ID: 9000098054 CO: City of Lafayett,62.99,,Posted,8137.69,Utilities
2021-10-14,,TYPE: DEPOSIT ID: C592126793 CO: MERCHANT BANKCD,,589.3,Posted,8200.68,Income
2021-10-13,,TYPE: XCELENERGY ID: 5840296600 CO: XCEL ENERGY-PSCO,427.38,,Posted,7611.38,Utilities
2021-10-13,,TYPE: DEPOSIT ID: C592126793 CO: MERCHANT BANKCD,,138.32,Posted,8038.76,Income
2021-10-13,,ABC*Anytime Fitness 888-8279262 CO Card 5089,45,,Posted,7900.44,Gym
2021-10-12,,TYPE: DEPOSIT ID: C592126793 CO: MERCHANT BANKCD,1.04,,Posted,7945.44,Uncategorized
2021-10-12,,TYPE: DEPOSIT ID: C592126793 CO: MERCHANT BANKCD,,559.57,Posted,7946.48,Income
2021-10-12,,TYPE: DEPOSIT ID: C592126793 CO: MERCHANT BANKCD,,456.65,Posted,7386.91,Income
2021-10-12,,TYPE: Settlement ID: 9000904746 CO: VISION QUEST MAR,,429,Posted,6930.26,Uncategorized
2021-10-12,,TYPE: DEPOSIT ID: C592126793 CO: MERCHANT BANKCD,,123.38,Posted,6501.26,Income
2021-10-12,,THE BOLD LOOK USA LLC 800-230-2653 FL Date 10/11/21 24493981284200354500355 Card 5089,67.21,,Posted,6377.88,Uncategorized
2021-10-10,,SMORE.COM WWW.SMORE.COM PA Card 5089,29,,Posted,6445.09,Electronics &amp; Software
2021-10-08,,TYPE: DEPOSIT ID: C592126793 CO: MERCHANT BANKCD,,138.84,Posted,6474.09,Income
2021-10-08,,CEN*CENTURY MA 800-626-2787 OK Date 10/08/21 24692161281100553231920 Card 5089,18.39,,Posted,6335.25,Shopping
2021-10-07,,TYPE: Rent ID: 116943300A CO: Amterre Lincoln,5737.43,,Posted,6353.64,Transfer
2021-10-07,,TYPE: DEPOSIT ID: C592126793 CO: MERCHANT BANKCD,2.09,,Posted,12091.07,Uncategorized
2021-10-07,,TYPE: Settlement ID: 9000904746 CO: VISION QUEST MAR,,707,Posted,12093.16,Uncategorized
2021-10-07,,TYPE: COMB. DEP. ID: 7300604847 CO: 5/3 BANKCARD SYS,,35.79,Posted,11386.16,Income
2021-10-06,,CEN*CENTURY MA 800-626-2787 OK Date 10/06/21 24692161279100056191633 Card 5089,129.56,,Posted,11350.37,Shopping
2021-10-06,,TYPE: DEPOSIT ID: C592126793 CO: MERCHANT BANKCD,,679.79,Posted,11479.93,Income
2021-10-05,,TYPE: BILLNG ID: 7300604847 CO: VANTIV_INTG_PYMT,235.33,,Posted,10800.14,Home
2021-10-05,,TYPE: DEPOSIT ID: C592126793 CO: MERCHANT BANKCD,,146.84,Posted,11035.47,Income
2021-10-05,,TYPE: Settlement ID: 9000904746 CO: VISION QUEST MAR,,130,Posted,10888.63,Uncategorized
2021-10-05,,TYPE: COMB. DEP. ID: 7300604847 CO: 5/3 BANKCARD SYS,,30,Posted,10758.63,Income
2021-10-04,,TYPE: DEPOSIT ID: C592126793 CO: MERCHANT BANKCD,99.78,,Posted,10728.63,Uncategorized
2021-10-04,,TYPE: DEPOSIT ID: C592126793 CO: MERCHANT BANKCD,,1124.54,Posted,10828.41,Income
2021-10-04,,TYPE: DEPOSIT ID: C592126793 CO: MERCHANT BANKCD,,425,Posted,9703.87,Income
2021-10-04,,TYPE: Settlement ID: 9000904746 CO: VISION QUEST MAR,,130.5,Posted,9278.87,Uncategorized
2021-10-01,,TYPE: DEPOSIT ID: C592126793 CO: MERCHANT BANKCD,1.04,,Posted,9148.37,Uncategorized
2021-10-01,,TYPE: Settlement ID: 9000904746 CO: VISION QUEST MAR,,155,Posted,9149.41,Uncategorized
2021-10-01,,TYPE: COMB. DEP. ID: 7300604847 CO: 5/3 BANKCARD SYS,,21.69,Posted,8994.41,Income
2021-10-01,,CALENDLY HTTPSCALENDLY GA Date 10/01/21 24011341274000016254843 Card 5089,15,,Posted,8972.72,Electronics &amp; Software
2021-09-30,,Withdrawal Acct Svc Charge,10,,Posted,8987.72,Uncategorized
2021-09-30,,ASIAN WORLD OF MARTIAL AR 800-3452962 PA Date 09/29/21 24639231273900014300496 Card 5089,232.63,,Posted,8997.72,Food &amp; Dining
2021-09-30,,TYPE: QUICKBOOKS ID: 1722616679 CO: INTUIT PAYROLL S,7076.94,,Posted,9230.35,Business Services
2021-09-30,,TYPE: DEPOSIT ID: C592126793 CO: MERCHANT BANKCD,,137.27,Posted,16307.29,Income
2021-09-29,,TYPE: DEPOSIT ID: C592126793 CO: MERCHANT BANKCD,,976.09,Posted,16170.02,Income
2021-09-29,,CORALTREE-QBOX 408-448-7269 CA Date 09/29/21 24492151272743935499758 Card 5089,12,,Posted,15193.93,Charity
2021-09-28,,TYPE: DEPOSIT ID: C592126793 CO: MERCHANT BANKCD,,419.73,Posted,15205.93,Income
2021-09-28,,TYPE: COMB. DEP. ID: 7300604847 CO: 5/3 BANKCARD SYS,,88.94,Posted,14786.2,Income
2021-09-27,,CANVA* I03191-21372308 HTTPSCANVA.CO DE Card 5089,12.99,,Posted,14697.26,Shopping
2021-09-27,,TYPE: DEPOSIT ID: C592126793 CO: MERCHANT BANKCD,1.04,,Posted,14710.25,Uncategorized
2021-09-27,,TYPE: DEPOSIT ID: C592126793 CO: MERCHANT BANKCD,,435.14,Posted,14711.29,Income
2021-09-27,,TYPE: DEPOSIT ID: C592126793 CO: MERCHANT BANKCD,,270.23,Posted,14276.15,Income
2021-09-27,,TYPE: COMB. DEP. ID: 7300604847 CO: 5/3 BANKCARD SYS,,130.17,Posted,14005.92,Income
2021-09-27,,MASTERLINE CO. 562-944-0036 CA Date 09/23/21 24388961269030046364186 Card 5089,300.39,,Posted,13875.75,Travel
2021-09-26,,ZOOM.US 888-799-9666 WWW.ZOOM.US CA Date 09/26/21 24011341269000046843497 Card 5089,32.53,,Posted,14176.14,Business Services
2021-09-24,,VISA INTERNATIONAL SERVICE ASSESSMENT Date 09/23/21 Card 5089,0.47,,Posted,14208.67,Uncategorized
2021-09-24,,LAWDEPOT COM 877-5094398 CA Date 09/23/21 74924271267132679573679 Card 5089,59,,Posted,14209.14,Legal
2021-09-24,,COMCAST CABLE COMM 800-COMCAST CO Card 5089,190.4,,Posted,14268.14,Utilities
2021-09-24,,TYPE: DEPOSIT ID: C592126793 CO: MERCHANT BANKCD,,438.51,Posted,14458.54,Income
2021-09-24,,TYPE: COMB. DEP. ID: 7300604847 CO: 5/3 BANKCARD SYS,,267.58,Posted,14020.03,Income
2021-09-23,,SP * HANDMADESWORD.COM HTTPSHANDMADE CA Date 09/23/21 24492161267000001759334 Card 5089,148.99,,Posted,13752.45,Uncategorized
2021-09-23,,TYPE: PAYMENT ID: CITICARDAP CO: CITI AUTOPAY,291.76,,Posted,13901.44,Credit Card Payment
2021-09-23,,TYPE: DEPOSIT ID: C592126793 CO: MERCHANT BANKCD,0.52,,Posted,14193.2,Uncategorized
2021-09-23,,TYPE: COMB. DEP. ID: 7300604847 CO: 5/3 BANKCARD SYS,,387.66,Posted,14193.72,Income
2021-09-23,,CEN*CENTURY MA 800-626-2787 OK Date 09/23/21 24692161266100879253342 Card 5089,217.99,,Posted,13806.06,Shopping
2021-09-22,,DRI*AVG TECHNOLOGIES www.avg.com MN Card 5089,69.99,,Posted,14024.05,Electronics &amp; Software
2021-09-22,,TYPE: DEPOSIT ID: C592126793 CO: MERCHANT BANKCD,18.25,,Posted,14094.04,Uncategorized
2021-09-21,,TYPE: Settlement ID: 9000904746 CO: VISION QUEST MAR,,630,Posted,14112.29,Uncategorized
2021-09-21,,TYPE: DEPOSIT ID: C592126793 CO: MERCHANT BANKCD,,554.79,Posted,13482.29,Income
2021-09-21,,TYPE: COMB. DEP. ID: 7300604847 CO: 5/3 BANKCARD SYS,,522.79,Posted,12927.5,Income
2021-09-21,,ABC*Anytime Fitness 888-8279262 CO Card 5089,32.3,,Posted,12404.71,Gym
2021-09-20,,TYPE: TaxPaymnt ID: T846000537 CO: Dept. of Revenue,162.18,,Posted,12437.01,State Tax
2021-09-20,,TYPE: DEPOSIT ID: C592126793 CO: MERCHANT BANKCD,0.52,,Posted,12599.19,Uncategorized
2021-09-20,,TYPE: Settlement ID: 9000904746 CO: VISION QUEST MAR,,447,Posted,12599.71,Uncategorized
2021-09-20,,TYPE: DEPOSIT ID: C592126793 CO: MERCHANT BANKCD,,435.14,Posted,12152.71,Income
2021-09-20,,TYPE: COMB. DEP. ID: 7300604847 CO: 5/3 BANKCARD SYS,,166.73,Posted,11717.57,Income
2021-09-20,,TYPE: DEPOSIT ID: C592126793 CO: MERCHANT BANKCD,,138.84,Posted,11550.84,Income
2021-09-20,,TYPE: COMB. DEP. ID: 7300604847 CO: 5/3 BANKCARD SYS,,25.76,Posted,11412,Income
2021-09-20,,MASTERLINE CO. 562-944-0036 CA Date 09/16/21 24388961262030046436544 Card 5089,200.9,,Posted,11386.24,Travel
2021-09-17,,TYPE: DEPOSIT ID: C592126793 CO: MERCHANT BANKCD,4.7,,Posted,11587.14,Uncategorized
2021-09-17,,TYPE: Settlement ID: 9000904746 CO: VISION QUEST MAR,,220,Posted,11591.84,Uncategorized
2021-09-17,,TYPE: COMB. DEP. ID: 7300604847 CO: 5/3 BANKCARD SYS,,181.92,Posted,11371.84,Income
2021-09-17,,CEN*CENTURY MA 800-626-2787 OK Date 09/17/21 24692161260100343250920 Card 5089,36.08,,Posted,11189.92,Shopping
2021-09-16,,KICKSITE 913-681-9949 KS Date 09/16/21 24055221259200832505382 Card 5089,149,,Posted,11226,Charity
2021-09-16,,TYPE: DEPOSIT ID: C592126793 CO: MERCHANT BANKCD,,952.19,Posted,11375,Income
2021-09-16,,CEN*CENTURY MA 800-626-2787 OK Date 09/16/21 24692161259100563923878 Card 5089,76.86,,Posted,10422.81,Shopping
2021-09-15,,TYPE: USATAXPYMT ID: 3387702000 CO: IRS,2545.65,,Posted,10499.67,Federal Tax
2021-09-15,,TYPE: TaxPaymnt ID: T846000537 CO: Dept. of Revenue,393,,Posted,13045.32,State Tax
2021-09-15,,TYPE: USATAXPYMT ID: 3387702000 CO: IRS,230.96,,Posted,13438.32,Federal Tax
2021-09-15,,TYPE: TaxPaymnt ID: T846000537 CO: Dept. of Revenue,3,,Posted,13669.28,State Tax
2021-09-15,,TYPE: Settlement ID: 9000904746 CO: VISION QUEST MAR,,320,Posted,13672.28,Uncategorized
2021-09-15,,TYPE: DEPOSIT ID: C592126793 CO: MERCHANT BANKCD,,289.08,Posted,13352.28,Income
2021-09-15,,SPOTIFY 877-778-1161 NY Card 5089,10.84,,Posted,13063.2,Music
2021-09-14,,MASTERLINE CO. 562-944-0036 CA Date 09/13/21 24388961257030021783354 Card 5089,225.95,,Posted,13074.04,Travel
2021-09-14,,Intuit *Payroll 833-830-9255 CA Date 09/14/21 24692161257100272339293 Card 5089,650,,Posted,13299.99,Business Services
2021-09-14,,TYPE: DEPOSIT ID: C592126793 CO: MERCHANT BANKCD,,721.48,Posted,13949.99,Income
2021-09-13,2485,Check 2485,284.44,,Posted,13228.51,Check
2021-09-13,,TYPE: XCELENERGY ID: 5840296600 CO: XCEL ENERGY-PSCO,573.3,,Posted,13512.95,Utilities
2021-09-13,,TYPE: DEPOSIT ID: C592126793 CO: MERCHANT BANKCD,1.04,,Posted,14086.25,Uncategorized
2021-09-13,,TYPE: DEPOSIT ID: C592126793 CO: MERCHANT BANKCD,,282.42,Posted,14087.29,Income
2021-09-13,,TYPE: DEPOSIT ID: C592126793 CO: MERCHANT BANKCD,,141.19,Posted,13804.87,Income
2021-09-13,,ABC*Anytime Fitness 888-8279262 CO Card 5089,45,,Posted,13663.68,Gym
2021-09-13,,MASTERLINE CO. 562-944-0036 CA Date 09/10/21 24388961255030045527227 Card 5089,93.45,,Posted,13708.68,Travel
2021-09-12,,ASIAN WORLD OF MARTIAL AR 800-3452962 PA Date 09/10/21 24639231255900012400910 Card 5089,410.37,,Posted,13802.13,Food &amp; Dining
2021-09-11,,CEN*CENTURY MA 800-626-2787 OK Date 09/11/21 24692161254100239066743 Card 5089,280.84,,Posted,14212.5,Shopping
2021-09-10,,ASIAN WORLD OF MARTIAL AR 800-3452962 PA Date 09/09/21 24639231253900012300278 Card 5089,230.51,,Posted,14493.34,Food &amp; Dining
2021-09-10,,TYPE: Rent ID: 116943300A CO: Amterre Lincoln,5857.87,,Posted,14723.85,Transfer
2021-09-10,,TYPE: DEPOSIT ID: C592126793 CO: MERCHANT BANKCD,1.04,,Posted,20581.72,Uncategorized
2021-09-10,,TYPE: Settlement ID: 9000904746 CO: VISION QUEST MAR,,574,Posted,20582.76,Uncategorized
2021-09-10,,CEN*CENTURY MA 800-626-2787 OK Date 09/10/21 24692161253100036143498 Card 5089,219.93,,Posted,20008.76,Shopping
2021-09-10,,SMORE.COM WWW.SMORE.COM PA Card 5089,29,,Posted,20228.69,Electronics &amp; Software
2021-09-09,,TYPE: DEPOSIT ID: C592126793 CO: MERCHANT BANKCD,,483.46,Posted,20257.69,Income
2021-09-08,,TYPE: BILLNG ID: 7300604847 CO: VANTIV_INTG_PYMT,259.64,,Posted,19774.23,Home
2021-09-08,,TYPE: Settlement ID: 9000904746 CO: VISION QUEST MAR,,562,Posted,20033.87,Uncategorized
2021-09-08,,TYPE: DEPOSIT ID: C592126793 CO: MERCHANT BANKCD,,138.84,Posted,19471.87,Income
2021-09-07,2477,Check 2477,865.64,,Posted,19333.03,Check
2021-09-07,,TYPE: PURCHASE ID: 9000098054 CO: City of Lafayett,114.52,,Posted,20198.67,Utilities
2021-09-07,,TYPE: DEPOSIT ID: C592126793 CO: MERCHANT BANKCD,2.09,,Posted,20313.19,Uncategorized
2021-09-07,,TYPE: DEPOSIT ID: C592126793 CO: MERCHANT BANKCD,,679.79,Posted,20315.28,Income
2021-09-07,,TYPE: COMB. DEP. ID: 7300604847 CO: 5/3 BANKCARD SYS,,502.96,Posted,19635.49,Income
2021-09-07,,TYPE: DEPOSIT ID: C592126793 CO: MERCHANT BANKCD,,390.28,Posted,19132.53,Income
2021-09-07,,TYPE: COMB. DEP. ID: 7300604847 CO: 5/3 BANKCARD SYS,,209.33,Posted,18742.25,Income
2021-09-07,,TYPE: DEPOSIT ID: C592126793 CO: MERCHANT BANKCD,,146.84,Posted,18532.92,Income
2021-09-07,,TYPE: COMB. DEP. ID: 7300604847 CO: 5/3 BANKCARD SYS,,49,Posted,18386.08,Income
2021-09-04,,MORRELL PRINTING SOLUTION 303-6654210 CO Date 09/03/21 24559301246900014200226 Card 5089,13.69,,Posted,18337.08,Printing
2021-09-03,2472,Check 2472,2615.17,,Posted,18350.77,Check
2021-09-03,2475,Check 2475,1933.4,,Posted,20965.94,Check
2021-09-03,2471,Check 2471,1723,,Posted,22899.34,Check
2021-09-03,,TYPE: DEPOSIT ID: C592126793 CO: MERCHANT BANKCD,99.25,,Posted,24622.34,Uncategorized
2021-09-03,,TYPE: Settlement ID: 9000904746 CO: VISION QUEST MAR,,130.5,Posted,24721.59,Uncategorized
2021-09-02,,TYPE: DEPOSIT ID: C592126793 CO: MERCHANT BANKCD,,1262.86,Posted,24591.09,Income
2021-09-02,,TYPE: COMB. DEP. ID: 7300604847 CO: 5/3 BANKCARD SYS,,489.33,Posted,23328.23,Income
2021-09-01,,Deposit Link24 T:F2S32LYMLF2-01,,225,Posted,22838.9,Transfer
2021-09-01,,SWEET COW LOUISVILLE LOUISVILLE CO Date 08/31/21 24717051244172446113946 Card 5089,607.1,,Posted,22613.9,Fast Food
2021-09-01,,CALENDLY HTTPSCALENDLY GA Date 09/01/21 24011341244000017288193 Card 5089,15,,Posted,23221,Electronics &amp; Software
2021-08-31,,Withdrawal Acct Svc Charge,10,,Posted,23236,Uncategorized
2021-08-31,,FACEBK 97YE58BGJ2 650-5434800 CA Date 08/31/21 24204291243000149477255 Card 5089,59.99,,Posted,23246,Amusement
2021-08-31,,TYPE: Settlement ID: 9000904746 CO: VISION QUEST MAR,,155,Posted,23305.99,Uncategorized
2021-08-31,,TYPE: DEPOSIT ID: C592126793 CO: MERCHANT BANKCD,,138.84,Posted,23150.99,Income
2021-08-30,,TYPE: DEPOSIT ID: C592126793 CO: MERCHANT BANKCD,1.04,,Posted,23012.15,Uncategorized
2021-08-30,,TYPE: DEPOSIT ID: C592126793 CO: MERCHANT BANKCD,,683.48,Posted,23013.19,Income
2021-08-30,,TYPE: DEPOSIT ID: C592126793 CO: MERCHANT BANKCD,,567.1,Posted,22329.71,Income
2021-08-30,,TYPE: COMB. DEP. ID: 7300604847 CO: 5/3 BANKCARD SYS,,336.72,Posted,21762.61,Income
2021-08-29,,CORALTREE-QBOX 408-448-7269 CA Date 08/29/21 24492151241743917424632 Card 5089,12,,Posted,21425.89,Charity
2021-08-27,,CANVA* I03160-20569780 HTTPSCANVA.CO DE Card 5089,12.99,,Posted,21437.89,Shopping
2021-08-27,,TYPE: COMB. DEP. ID: 7300604847 CO: 5/3 BANKCARD SYS,,496.61,Posted,21450.88,Income
2021-08-27,,TYPE: DEPOSIT ID: C592126793 CO: MERCHANT BANKCD,,394.66,Posted,20954.27,Income
2021-08-26,,ZOOM.US 888-799-9666 WWW.ZOOM.US CA Date 08/26/21 24011341238000049505968 Card 5089,32.53,,Posted,20559.61,Business Services
2021-08-26,,TYPE: DEPOSIT ID: C592126793 CO: MERCHANT BANKCD,,518.96,Posted,20592.14,Income
2021-08-26,,CEN*CENTURY MA 800-626-2787 OK Date 08/26/21 24692161238100342660664 Card 5089,72.01,,Posted,20073.18,Shopping
2021-08-26,,IN *STREAMLINE ACCOUNTING 970-4332368 CO Date 08/25/21 24692161237100093696553 Card 5089,650,,Posted,20145.19,Business Services
2021-08-26,,IN *STREAMLINE ACCOUNTING 970-4332368 CO Date 08/25/21 24692161237100093696546 Card 5089,500,,Posted,20795.19,Business Services
2021-08-25,,Audible*255ED0ZP1 Amzn.com/bill NJ Date 08/25/21 24692161237100864714353 Card 5089,16.22,,Posted,21295.19,Books
2021-08-25,,TYPE: DEPOSIT ID: C592126793 CO: MERCHANT BANKCD,1.04,,Posted,21311.41,Uncategorized
2021-08-24,,TYPE: PAYMENT ID: CITICARDAP CO: CITI AUTOPAY,315.96,,Posted,21312.45,Credit Card Payment
2021-08-24,,TYPE: DEPOSIT ID: C592126793 CO: MERCHANT BANKCD,,439.01,Posted,21628.41,Income
2021-08-24,,COMCAST CABLE COMM 800-COMCAST CO Card 5089,190.34,,Posted,21189.4,Utilities
2021-08-23,,TYPE: DEPOSIT ID: C592126793 CO: MERCHANT BANKCD,0.52,,Posted,21379.74,Uncategorized
2021-08-23,,TYPE: DEPOSIT ID: C592126793 CO: MERCHANT BANKCD,,902.92,Posted,21380.26,Income
2021-08-23,,TYPE: COMB. DEP. ID: 7300604847 CO: 5/3 BANKCARD SYS,,168.89,Posted,20477.34,Income
2021-08-23,,TYPE: DEPOSIT ID: C592126793 CO: MERCHANT BANKCD,,136.75,Posted,20308.45,Income
2021-08-21,,ABC*Anytime Fitness 888-8279262 CO Card 5089,32.3,,Posted,20171.7,Gym
2021-08-20,,TYPE: TaxPaymnt ID: T846000537 CO: Dept. of Revenue,70.25,,Posted,20204,State Tax
2021-08-20,,TYPE: DEPOSIT ID: C592126793 CO: MERCHANT BANKCD,1.04,,Posted,20274.25,Uncategorized
2021-08-20,,TYPE: Settlement ID: 9000904746 CO: VISION QUEST MAR,,1077,Posted,20275.29,Uncategorized
2021-08-20,,TYPE: COMB. DEP. ID: 7300604847 CO: 5/3 BANKCARD SYS,,181.92,Posted,19198.29,Income
2021-08-19,,TYPE: Settlement ID: 9000904746 CO: VISION QUEST MAR,,310,Posted,19016.37,Uncategorized
2021-08-19,,TYPE: DEPOSIT ID: C592126793 CO: MERCHANT BANKCD,,136.75,Posted,18706.37,Income
2021-08-19,,TYPE: COMB. DEP. ID: 7300604847 CO: 5/3 BANKCARD SYS,,56.39,Posted,18569.62,Income
2021-08-18,,TYPE: Settlement ID: 9000904746 CO: VISION QUEST MAR,,304,Posted,18513.23,Uncategorized
2021-08-18,,TYPE: DEPOSIT ID: C592126793 CO: MERCHANT BANKCD,,138.84,Posted,18209.23,Income
2021-08-17,,TYPE: DEPOSIT ID: C592126793 CO: MERCHANT BANKCD,,238.94,Posted,18070.39,Income
2021-08-17,,TYPE: COMB. DEP. ID: 7300604847 CO: 5/3 BANKCARD SYS,,57.47,Posted,17831.45,Income
2021-08-16,,KICKSITE 913-681-9949 KS Date 08/16/21 24055221228200832405235 Card 5089,149,,Posted,17773.98,Charity
2021-08-16,,TYPE: DEPOSIT ID: C592126793 CO: MERCHANT BANKCD,1.04,,Posted,17922.98,Uncategorized
2021-08-16,,TYPE: COMB. DEP. ID: 7300604847 CO: 5/3 BANKCARD SYS,,806.83,Posted,17924.02,Income
2021-08-16,,TYPE: DEPOSIT ID: C592126793 CO: MERCHANT BANKCD,,804.3,Posted,17117.19,Income
2021-08-16,,TYPE: DEPOSIT ID: C592126793 CO: MERCHANT BANKCD,,157.99,Posted,16312.89,Income
2021-08-16,,TYPE: Settlement ID: 9000904746 CO: VISION QUEST MAR,,145,Posted,16154.9,Uncategorized
2021-08-16,,TYPE: COMB. DEP. ID: 7300604847 CO: 5/3 BANKCARD SYS,,57.47,Posted,16009.9,Income
2021-08-15,,SPOTIFY 877-778-1161 NY Card 5089,10.84,,Posted,15952.43,Music
2021-08-13,,THE HOME DEPOT #1548 BROOMFIELD CO Date 08/12/21 24943011225010191034342 Card 5089,183.68,,Posted,15963.27,Home Improvement
2021-08-13,,TYPE: XCELENERGY ID: 5840296600 CO: XCEL ENERGY-PSCO,499.62,,Posted,16146.95,Utilities
2021-08-13,,TYPE: DEPOSIT ID: C592126793 CO: MERCHANT BANKCD,1.04,,Posted,16646.57,Uncategorized
2021-08-13,,TYPE: COMB. DEP. ID: 7300604847 CO: 5/3 BANKCARD SYS,,216.62,Posted,16647.61,Income
2021-08-13,,TYPE: Settlement ID: 9000904746 CO: VISION QUEST MAR,,165,Posted,16430.99,Uncategorized
2021-08-13,,ABC*Anytime Fitness 888-8279262 CO Card 5089,45,,Posted,16265.99,Gym
2021-08-12,,TYPE: COMB. DEP. ID: 7300604847 CO: 5/3 BANKCARD SYS,,309.88,Posted,16310.99,Income
2021-08-12,,TYPE: DEPOSIT ID: C592126793 CO: MERCHANT BANKCD,,124.43,Posted,16001.11,Income
2021-08-11,,Deposit Link24 T:2BNWH5VMLF2-01,,45,Posted,15876.68,Transfer
2021-08-11,,TYPE: Settlement ID: 9000904746 CO: VISION QUEST MAR,,594,Posted,15831.68,Uncategorized
2021-08-11,,TYPE: DEPOSIT ID: C592126793 CO: MERCHANT BANKCD,,405.5,Posted,15237.68,Income
2021-08-10,,TYPE: QUICKBOOKS ID: 1722616679 CO: INTUIT PAYROLL S,1400.16,,Posted,14832.18,Business Services
2021-08-10,,TYPE: DEPOSIT ID: C592126793 CO: MERCHANT BANKCD,1.04,,Posted,16232.34,Uncategorized
2021-08-10,,CEN*CENTURY MA 800-626-2787 OK Date 08/10/21 24692161222100016839071 Card 5089,97.18,,Posted,16233.38,Shopping
2021-08-10,,SMORE.COM WWW.SMORE.COM PA Card 5089,29,,Posted,16330.56,Electronics &amp; Software
2021-08-09,,TYPE: Rent ID: 116943300A CO: Amterre Lincoln,5737.43,,Posted,16359.56,Transfer
2021-08-09,,TYPE: BILLNG ID: 7300604847 CO: VANTIV_INTG_PYMT,256.54,,Posted,22096.99,Home
2021-08-09,,TYPE: DEPOSIT ID: C592126793 CO: MERCHANT BANKCD,2.09,,Posted,22353.53,Uncategorized
2021-08-09,,TYPE: COMB. DEP. ID: 7300604847 CO: 5/3 BANKCARD SYS,,583.38,Posted,22355.62,Income
2021-08-09,,TYPE: DEPOSIT ID: C592126793 CO: MERCHANT BANKCD,,295.78,Posted,21772.24,Income
2021-08-09,,TYPE: TRANSFER ID: PAYPALSD11 CO: PAYPAL,,295.22,Posted,21476.46,Transfer
2021-08-09,,TYPE: COMB. DEP. ID: 7300604847 CO: 5/3 BANKCARD SYS,,225,Posted,21181.24,Income
2021-08-09,,TYPE: TRANSFER ID: PAYPALSD11 CO: PAYPAL,,167.79,Posted,20956.24,Transfer
2021-08-09,,TYPE: Settlement ID: 9000904746 CO: VISION QUEST MAR,,145,Posted,20788.45,Uncategorized
2021-08-09,,TYPE: DEPOSIT ID: C592126793 CO: MERCHANT BANKCD,,138.84,Posted,20643.45,Income
2021-08-07,,BOB L BURGER RECREATION C 303-6650987 CO Date 08/06/21 24755421219642194242989 Card 5089,60,,Posted,20504.61,Food &amp; Dining
2021-08-07,,INSTANT IMPRINTS LOUISVI LOUISVILLE CO Date 08/06/21 24801971218726990456460 Card 5089,758.17,,Posted,20564.61,Uncategorized
2021-08-06,,TYPE: PURCHASE ID: 9000098054 CO: City of Lafayett,49.62,,Posted,21322.78,Utilities
2021-08-06,,TYPE: DEPOSIT ID: C592126793 CO: MERCHANT BANKCD,,679.79,Posted,21372.4,Income
2021-08-05,,TYPE: Settlement ID: 9000904746 CO: VISION QUEST MAR,,562,Posted,20692.61,Uncategorized
2021-08-05,,TYPE: DEPOSIT ID: C592126793 CO: MERCHANT BANKCD,,146.84,Posted,20130.61,Income
2021-08-05,,TYPE: COMB. DEP. ID: 7300604847 CO: 5/3 BANKCARD SYS,,17.35,Posted,19983.77,Income
2021-08-05,,IN *STREAMLINE ACCOUNTING 970-4332368 CO Date 08/04/21 24692161216100080968267 Card 5089,71.25,,Posted,19966.42,Business Services
2021-08-05,,IN *STREAMLINE ACCOUNTING 970-4332368 CO Date 08/04/21 24692161216100080968259 Card 5089,202.9,,Posted,20037.67,Business Services
2021-08-04,,TYPE: DEPOSIT ID: C592126793 CO: MERCHANT BANKCD,,425,Posted,20240.57,Income
2021-08-03,2473,Check 2473,455.51,,Posted,19815.57,Check
2021-08-03,,TYPE: DEPOSIT ID: C592126793 CO: MERCHANT BANKCD,99.25,,Posted,20271.08,Uncategorized
2021-08-03,,TYPE: Settlement ID: 9000904746 CO: VISION QUEST MAR,,130.5,Posted,20370.33,Uncategorized
2021-08-03,,TYPE: COMB. DEP. ID: 7300604847 CO: 5/3 BANKCARD SYS,,120,Posted,20239.83,Income
2021-08-02,,TYPE: PRM PYMT ID: 9437678001 CO: COLO UI ER SV,165.58,,Posted,20119.83,Uncategorized
2021-08-02,,TYPE: DEPOSIT ID: C592126793 CO: MERCHANT BANKCD,,1263.9,Posted,20285.41,Income
2021-08-02,,TYPE: COMB. DEP. ID: 7300604847 CO: 5/3 BANKCARD SYS,,277.05,Posted,19021.51,Income
2021-08-01,,CALENDLY HTTPSCALENDLY GA Date 08/01/21 24011341213000019103611 Card 5089,15,,Posted,18744.46,Electronics &amp; Software
2021-07-31,,Withdrawal Acct Svc Charge,10,,Posted,18759.46,Uncategorized
2021-07-31,,AMAZON.COM*2P2WJ3CX2 SEATTLE WA Card 5089,29.06,,Posted,18769.46,Shopping
2021-07-31,,AMAZON.COM*2P1LE7C42 SEATTLE WA Card 5089,19.14,,Posted,18798.52,Shopping
2021-07-31,,DOMINO'S 6371 303-449-7101 CO Date 07/30/21 24445001212500516939554 Card 5089,35,,Posted,18817.66,Fast Food
2021-07-31,,AMAZON.COM*2P22E0GE1 SEATTLE WA Card 5089,42.55,,Posted,18852.66,Shopping
2021-07-30,,CEN*CENTURY MA 800-626-2787 OK Date 07/30/21 24692161211100648956403 Card 5089,26.2,,Posted,18895.21,Shopping
2021-07-30,,TYPE: QUICKBOOKS ID: 1722616679 CO: INTUIT PAYROLL S,7840.45,,Posted,18921.41,Business Services
2021-07-30,,TYPE: EPS ID: H03900 CO: JACK HENRY &amp; ASC,51.66,,Posted,26761.86,Uncategorized
2021-07-30,,TYPE: DEPOSIT ID: C592126793 CO: MERCHANT BANKCD,1.57,,Posted,26813.52,Uncategorized
2021-07-30,,TYPE: Settlement ID: 9000904746 CO: VISION QUEST MAR,,155,Posted,26815.09,Uncategorized
2021-07-30,,TYPE: COMB. DEP. ID: 7300604847 CO: 5/3 BANKCARD SYS,,14.09,Posted,26660.09,Income
2021-07-29,,Deposit Link24 T:DHZNG5VMLF2-01,,25,Posted,26646,Transfer
2021-07-29,,Deposit Link24 T:9W71H5VMLS1-01,,360,Posted,26621,Transfer
2021-07-29,,CORALTREE-QBOX 408-448-7269 CA Date 07/29/21 24492151210719972034265 Card 5089,12,,Posted,26261,Charity
2021-07-29,,TYPE: DEPOSIT ID: C592126793 CO: MERCHANT BANKCD,,684.53,Posted,26273,Income
2021-07-29,,TYPE: COMB. DEP. ID: 7300604847 CO: 5/3 BANKCARD SYS,,396.59,Posted,25588.47,Income
2021-07-28,,TYPE: DEPOSIT ID: C592126793 CO: MERCHANT BANKCD,,419.21,Posted,25191.88,Income
2021-07-28,,TYPE: Settlement ID: 9000904746 CO: VISION QUEST MAR,,165,Posted,24772.67,Uncategorized
2021-07-27,,CANVA* I03129-18051713 HTTPSCANVA.CO DE Card 5089,12.99,,Posted,24607.67,Shopping
2021-07-27,,TYPE: DEPOSIT ID: C592126793 CO: MERCHANT BANKCD,,533.5,Posted,24620.66,Income
2021-07-27,,TYPE: TRANSFER ID: PAYPALSD11 CO: PAYPAL,,383.52,Posted,24087.16,Transfer
2021-07-26,,ZOOM.US 888-799-9666 WWW.ZOOM.US CA Date 07/26/21 24011341207000049895366 Card 5089,32.53,,Posted,23703.64,Business Services
2021-07-26,,AMAZON.COM*2E74S9QA2 SEATTLE WA Card 5089,112.48,,Posted,23736.17,Shopping
2021-07-26,,AMAZON.COM*2E94O5QG2 SEATTLE WA Card 5089,22.4,,Posted,23848.65,Shopping
2021-07-26,,Audible*2E1OJ2K00 Amzn.com/bill NJ Date 07/25/21 24692161207100396572770 Card 5089,16.22,,Posted,23871.05,Books
2021-07-26,,TYPE: DEPOSIT ID: C592126793 CO: MERCHANT BANKCD,,517.92,Posted,23887.27,Income
2021-07-26,,TYPE: DEPOSIT ID: C592126793 CO: MERCHANT BANKCD,,439.01,Posted,23369.35,Income
2021-07-26,,TYPE: COMB. DEP. ID: 7300604847 CO: 5/3 BANKCARD SYS,,292.35,Posted,22930.34,Income
2021-07-26,,TYPE: COMB. DEP. ID: 7300604847 CO: 5/3 BANKCARD SYS,,239.09,Posted,22637.99,Income
2021-07-26,,TYPE: COMB. DEP. ID: 7300604847 CO: 5/3 BANKCARD SYS,,79.17,Posted,22398.9,Income
2021-07-24,,COMCAST CABLE COMM 800-COMCAST CO Card 5089,191.12,,Posted,22319.73,Utilities
2021-07-23,,TYPE: PAYMENT ID: CITICARDAP CO: CITI AUTOPAY,292.5,,Posted,22510.85,Credit Card Payment
2021-07-23,,TYPE: DEPOSIT ID: C592126793 CO: MERCHANT BANKCD,0.52,,Posted,22803.35,Uncategorized
2021-07-23,,TYPE: COMB. DEP. ID: 7300604847 CO: 5/3 BANKCARD SYS,,25.76,Posted,22803.87,Income
2021-07-23,,MASTERLINE CO. 562-944-0036 CA Date 07/21/21 24388961203030023994608 Card 5089,26.7,,Posted,22778.11,Travel
2021-07-22,,TYPE: COMB. DEP. ID: 7300604847 CO: 5/3 BANKCARD SYS,,397.35,Posted,22804.81,Income
2021-07-22,,TYPE: DEPOSIT ID: C592126793 CO: MERCHANT BANKCD,,136.75,Posted,22407.46,Income
2021-07-21,,TYPE: DEPOSIT ID: C592126793 CO: MERCHANT BANKCD,,893.34,Posted,22270.71,Income
2021-07-21,,TYPE: Settlement ID: 9000904746 CO: VISION QUEST MAR,,465,Posted,21377.37,Uncategorized
2021-07-21,,ABC*Anytime Fitness 888-8279262 CO Card 5089,32.3,,Posted,20912.37,Gym
2021-07-20,,TYPE: TaxPaymnt ID: T846000537 CO: Dept. of Revenue,47.78,,Posted,20944.67,State Tax
2021-07-20,,TYPE: DEPOSIT ID: C592126793 CO: MERCHANT BANKCD,0.52,,Posted,20992.45,Uncategorized
2021-07-20,,TYPE: Settlement ID: 9000904746 CO: VISION QUEST MAR,,481.7,Posted,20992.97,Uncategorized
2021-07-20,,TYPE: COMB. DEP. ID: 7300604847 CO: 5/3 BANKCARD SYS,,143.96,Posted,20511.27,Income
2021-07-19,,Deposit Link24 T:MP8TF5VMLF2-01,,100,Posted,20367.31,Transfer
2021-07-19,,TYPE: DEPOSIT ID: C592126793 CO: MERCHANT BANKCD,4.18,,Posted,20267.31,Uncategorized
2021-07-19,,TYPE: COMB. DEP. ID: 7300604847 CO: 5/3 BANKCARD SYS,,380.07,Posted,20271.49,Income
2021-07-19,,TYPE: COMB. DEP. ID: 7300604847 CO: 5/3 BANKCARD SYS,,266.8,Posted,19891.42,Income
2021-07-19,,TYPE: Settlement ID: 9000904746 CO: VISION QUEST MAR,,220,Posted,19624.62,Uncategorized
2021-07-19,,TYPE: DEPOSIT ID: C592126793 CO: MERCHANT BANKCD,,138.84,Posted,19404.62,Income
2021-07-19,,TYPE: DEPOSIT ID: C592126793 CO: MERCHANT BANKCD,,138.32,Posted,19265.78,Income
2021-07-19,,TYPE: COMB. DEP. ID: 7300604847 CO: 5/3 BANKCARD SYS,,17.35,Posted,19127.46,Income
2021-07-17,,CEN*CENTURY MA 800-626-2787 OK Date 07/17/21 24692161198100931675618 Card 5089,33.85,,Posted,19110.11,Shopping
2021-07-16,,KICKSITE 913-681-9949 KS Date 07/16/21 24055221197200832405174 Card 5089,149,,Posted,19143.96,Charity
2021-07-16,,TYPE: XCELENERGY ID: 5840296600 CO: XCEL ENERGY-PSCO,386.95,,Posted,19292.96,Utilities
2021-07-16,,TYPE: DEPOSIT ID: C592126793 CO: MERCHANT BANKCD,,770.56,Posted,19679.91,Income
2021-07-16,,TYPE: Settlement ID: 9000904746 CO: VISION QUEST MAR,,449,Posted,18909.35,Uncategorized
2021-07-16,,TYPE: COMB. DEP. ID: 7300604847 CO: 5/3 BANKCARD SYS,,17.35,Posted,18460.35,Income
2021-07-15,,TYPE: USATAXPYMT ID: 3387702000 CO: IRS,4585.62,,Posted,18443,Federal Tax
2021-07-15,,TYPE: TaxPaymnt ID: T846000537 CO: Dept. of Revenue,531,,Posted,23028.62,State Tax
2021-07-15,,TYPE: Settlement ID: 9000904746 CO: VISION QUEST MAR,,320,Posted,23559.62,Uncategorized
2021-07-15,,TYPE: COMB. DEP. ID: 7300604847 CO: 5/3 BANKCARD SYS,,275.52,Posted,23239.62,Income
2021-07-15,,TYPE: DEPOSIT ID: C592126793 CO: MERCHANT BANKCD,,0.78,Posted,22964.1,Income
2021-07-15,,AMAZON.COM*2E4LX6GS1 SEATTLE WA Card 5089,92.62,,Posted,22963.32,Shopping
2021-07-15,,SPOTIFY 877-778-1161 NY Card 5089,10.84,,Posted,23055.94,Music
2021-07-14,,Deposit Link24 T:G7Q3TRQMLF1-01,,1650,Posted,23066.78,Transfer
2021-07-14,,Deposit Link24 T:J6Q3TRQMLF1-01,,285,Posted,21416.78,Transfer
2021-07-14,,Deposit Link24 T:H8TXSRQMLF2-01,,50,Posted,21131.78,Transfer
2021-07-14,,Deposit Link24 T:B4Q3TRQMLF1-01,,100,Posted,21081.78,Transfer
2021-07-14,,Deposit Link24 T:24TXSRQMLF2-01,,125,Posted,20981.78,Transfer
2021-07-14,,TYPE: DEPOSIT ID: C592126793 CO: MERCHANT BANKCD,,157.99,Posted,20856.78,Income
2021-07-13,,TYPE: PURCHASE ID: 9000098054 CO: City of Lafayett,33.73,,Posted,20698.79,Utilities
2021-07-13,,TYPE: DEPOSIT ID: C592126793 CO: MERCHANT BANKCD,,32.71,Posted,20732.52,Income
2021-07-13,,MORRELL PRINTING SOLUTION 303-6654210 CO Date 07/12/21 24559301193900010300189 Card 5089,53.53,,Posted,20699.81,Printing
2021-07-13,,ABC*Anytime Fitness 888-8279262 CO Card 5089,45,,Posted,20753.34,Gym
2021-07-12,,TYPE: COMB. DEP. ID: 7300604847 CO: 5/3 BANKCARD SYS,,577.46,Posted,20798.34,Income
2021-07-12,,TYPE: DEPOSIT ID: C592126793 CO: MERCHANT BANKCD,,295.78,Posted,20220.88,Income
2021-07-12,,TYPE: DEPOSIT ID: C592126793 CO: MERCHANT BANKCD,,139.1,Posted,19925.1,Income
2021-07-12,,TYPE: DEPOSIT ID: C592126793 CO: MERCHANT BANKCD,,124.43,Posted,19786,Income
2021-07-12,,TYPE: COMB. DEP. ID: 7300604847 CO: 5/3 BANKCARD SYS,,35.79,Posted,19661.57,Income
2021-07-10,,SMORE.COM WWW.SMORE.COM PA Card 5089,29,,Posted,19625.78,Electronics &amp; Software
2021-07-09,,IN *STREAMLINE ACCOUNTING 970-4332368 CO Date 07/08/21 24692161190100626086863 Card 5089,138.75,,Posted,19654.78,Business Services
2021-07-09,,TYPE: Settlement ID: 9000904746 CO: VISION QUEST MAR,,764,Posted,19793.53,Uncategorized
2021-07-09,,TYPE: DEPOSIT ID: C592126793 CO: MERCHANT BANKCD,,446.38,Posted,19029.53,Income
2021-07-09,,INSTANT IMPRINTS LOUISVI LOUISVILLE CO Date 07/08/21 24801971189726470684115 Card 5089,809,,Posted,18583.15,Uncategorized
2021-07-08,,TYPE: DEPOSIT ID: C592126793 CO: MERCHANT BANKCD,,402.63,Posted,19392.15,Income
2021-07-08,,TYPE: Settlement ID: 9000904746 CO: VISION QUEST MAR,,397,Posted,18989.52,Uncategorized
2021-07-08,,MASTERLINE CO. 562-944-0036 CA Date 07/06/21 24388961188030022813204 Card 5089,510.19,,Posted,18592.52,Travel
2021-07-07,,ASIAN WORLD OF MARTIAL AR 800-3452962 PA Date 07/07/21 24639231188900015300358 Card 5089,381.61,,Posted,19102.71,Food &amp; Dining
2021-07-07,,CEN*CENTURY MA 800-626-2787 OK Date 07/07/21 24692161188100267930985 Card 5089,185.36,,Posted,19484.32,Shopping
2021-07-07,,TYPE: Rent ID: 116943300A CO: Amterre Lincoln,5737.43,,Posted,19669.68,Transfer
2021-07-07,,TYPE: BILLNG ID: 7300604847 CO: VANTIV_INTG_PYMT,302.94,,Posted,25407.11,Home
2021-07-07,,TYPE: DEPOSIT ID: C592126793 CO: MERCHANT BANKCD,2.09,,Posted,25710.05,Uncategorized
2021-07-06,,TYPE: DEPOSIT ID: C592126793 CO: MERCHANT BANKCD,,2786.57,Posted,25712.14,Income
2021-07-06,,TYPE: DEPOSIT ID: C592126793 CO: MERCHANT BANKCD,,679.79,Posted,22925.57,Income
2021-07-06,,TYPE: DEPOSIT ID: C592126793 CO: MERCHANT BANKCD,,424.48,Posted,22245.78,Income
2021-07-06,,TYPE: COMB. DEP. ID: 7300604847 CO: 5/3 BANKCARD SYS,,239.68,Posted,21821.3,Income
2021-07-06,,TYPE: COMB. DEP. ID: 7300604847 CO: 5/3 BANKCARD SYS,,224.6,Posted,21581.62,Income
2021-07-06,,TYPE: DEPOSIT ID: C592126793 CO: MERCHANT BANKCD,,146.84,Posted,21357.02,Income
2021-07-06,,TYPE: COMB. DEP. ID: 7300604847 CO: 5/3 BANKCARD SYS,,25,Posted,21210.18,Income
2021-07-02,,TYPE: Settlement ID: 9000904746 CO: VISION QUEST MAR,,130.5,Posted,21185.18,Uncategorized
2021-07-02,,TYPE: COMB. DEP. ID: 7300604847 CO: 5/3 BANKCARD SYS,,1,Posted,21054.68,Income
2021-07-01,,CALENDLY HTTPSCALENDLY GA Card 5089,15,,Posted,21053.68,Electronics &amp; Software
2021-07-01,,TYPE: TRANSFER ID: PAYPALSD11 CO: PAYPAL,,1015.6,Posted,21068.68,Transfer
2021-07-01,,TYPE: Settlement ID: 9000904746 CO: VISION QUEST MAR,,155,Posted,20053.08,Uncategorized
2021-07-01,,TYPE: DEPOSIT ID: C592126793 CO: MERCHANT BANKCD,,137.27,Posted,19898.08,Income
2021-07-01,,TYPE: TRANSFER ID: PAYPALSD11 CO: PAYPAL,,67.88,Posted,19760.81,Transfer
2021-06-30,,Withdrawal Acct Svc Charge,10,,Posted,19692.93,Uncategorized
2021-06-30,,TYPE: EPS ID: H03900 CO: JACK HENRY &amp; ASC,39.36,,Posted,19702.93,Uncategorized
2021-06-30,,TYPE: DEPOSIT ID: C592126793 CO: MERCHANT BANKCD,1.57,,Posted,19742.29,Uncategorized
2021-06-30,,THE BOLD LOOK 305-687-8725 FL Date 06/29/21 24493981180207724000441 Card 5089,219.89,,Posted,19743.86,Uncategorized
2021-06-29,,TYPE: QUICKBOOKS ID: 1722616679 CO: INTUIT PAYROLL S,8032.6,,Posted,19963.75,Business Services
2021-06-29,,TYPE: QUICKBOOKS ID: 1722616679 CO: INTUIT PAYROLL S,127.52,,Posted,27996.35,Business Services
2021-06-29,,TYPE: DEPOSIT ID: C592126793 CO: MERCHANT BANKCD,,684.53,Posted,28123.87,Income
2021-06-29,,CORALTREE-QBOX 408-448-7269 CA Date 06/29/21 24492151180743214368923 Card 5089,12,,Posted,27439.34,Charity
2021-06-28,,TYPE: DEPOSIT ID: C592126793 CO: MERCHANT BANKCD,2.09,,Posted,27451.34,Uncategorized
2021-06-28,,TYPE: COMB. DEP. ID: 7300604847 CO: 5/3 BANKCARD SYS,,1650,Posted,27453.43,Income
2021-06-28,,TYPE: DEPOSIT ID: C592126793 CO: MERCHANT BANKCD,,1237.27,Posted,25803.43,Income
2021-06-28,,TYPE: DEPOSIT ID: C592126793 CO: MERCHANT BANKCD,,518.96,Posted,24566.16,Income
2021-06-28,,TYPE: COMB. DEP. ID: 7300604847 CO: 5/3 BANKCARD SYS,,86.79,Posted,24047.2,Income
2021-06-27,,CANVA* 03099-15245032 HTTPSCANVA.CO DE Card 5089,12.99,,Posted,23960.41,Shopping
2021-06-26,,ZOOM.US 888-799-9666 WWW.ZOOM.US CA Date 06/26/21 24011341177000029443993 Card 5089,32.53,,Posted,23973.4,Business Services
2021-06-26,,DOMINO'S 6371 303-449-7101 CO Date 06/25/21 24445001177500558014558 Card 5089,60.98,,Posted,24005.93,Fast Food
2021-06-26,,Audible*215RB4SF0 Amzn.com/bill NJ Date 06/25/21 24692161177100538732726 Card 5089,16.22,,Posted,24066.91,Books
2021-06-25,2469,Check 2469,194.91,,Posted,24083.13,Check
2021-06-25,,TYPE: DEPOSIT ID: C592126793 CO: MERCHANT BANKCD,1.04,,Posted,24278.04,Uncategorized
2021-06-25,,TYPE: COMB. DEP. ID: 7300604847 CO: 5/3 BANKCARD SYS,,225,Posted,24279.08,Income
2021-06-24,,COMCAST CABLE COMM 800-COMCAST CO Card 5089,191.12,,Posted,24054.08,Utilities
2021-06-24,,TYPE: DEPOSIT ID: C592126793 CO: MERCHANT BANKCD,,439.01,Posted,24245.2,Income
2021-06-24,,TYPE: COMB. DEP. ID: 7300604847 CO: 5/3 BANKCARD SYS,,86.79,Posted,23806.19,Income
2021-06-23,,TYPE: PAYMENT ID: CITICARDAP CO: CITI AUTOPAY,312.28,,Posted,23719.4,Credit Card Payment
2021-06-23,,TYPE: DEPOSIT ID: C592126793 CO: MERCHANT BANKCD,0.52,,Posted,24031.68,Uncategorized
2021-06-23,,MORRELL PRINTING SOLUTION 303-6654210 CO Date 06/22/21 24559301173900019000073 Card 5089,25.49,,Posted,24032.2,Printing
2021-06-22,,TYPE: DEPOSIT ID: C592126793 CO: MERCHANT BANKCD,,136.75,Posted,24057.69,Income
2021-06-21,,TYPE: TaxPaymnt ID: T846000537 CO: Dept. of Revenue,16.29,,Posted,23920.94,State Tax
2021-06-21,,TYPE: DEPOSIT ID: C592126793 CO: MERCHANT BANKCD,1.04,,Posted,23937.23,Uncategorized
2021-06-21,,TYPE: COMB. DEP. ID: 7300604847 CO: 5/3 BANKCARD SYS,,1404.24,Posted,23938.27,Income
2021-06-21,,TYPE: DEPOSIT ID: C592126793 CO: MERCHANT BANKCD,,893.34,Posted,22534.03,Income
2021-06-21,,TYPE: Settlement ID: 9000904746 CO: VISION QUEST MAR,,445,Posted,21640.69,Uncategorized
2021-06-21,,TYPE: COMB. DEP. ID: 7300604847 CO: 5/3 BANKCARD SYS,,225,Posted,21195.69,Income
2021-06-21,,TYPE: DEPOSIT ID: C592126793 CO: MERCHANT BANKCD,,138.84,Posted,20970.69,Income
2021-06-21,,ABC*Anytime Fitness 888-8279262 CO Card 5089,32.3,,Posted,20831.85,Gym
2021-06-19,,Microsoft 1 Microsoft Way Redmon WA Card 5089,69.99,,Posted,20864.15,Electronics &amp; Software
2021-06-18,,TYPE: PURCHASE ID: 9000098054 CO: City of Lafayett,11.5,,Posted,20934.14,Utilities
2021-06-18,,TYPE: Settlement ID: 9000904746 CO: VISION QUEST MAR,,916,Posted,20945.64,Uncategorized
2021-06-18,,TYPE: DEPOSIT ID: C592126793 CO: MERCHANT BANKCD,,138.84,Posted,20029.64,Income
2021-06-17,,TYPE: DEPOSIT ID: C592126793 CO: MERCHANT BANKCD,4.18,,Posted,19890.8,Uncategorized
2021-06-17,,TYPE: COMB. DEP. ID: 7300604847 CO: 5/3 BANKCARD SYS,,1245.4,Posted,19894.98,Income
2021-06-16,,KICKSITE 913-681-9949 KS Date 06/16/21 24055221167200832405311 Card 5089,149,,Posted,18649.58,Charity
2021-06-16,,TYPE: DEPOSIT ID: C592126793 CO: MERCHANT BANKCD,,665.46,Posted,18798.58,Income
2021-06-16,,TYPE: Settlement ID: 9000904746 CO: VISION QUEST MAR,,300,Posted,18133.12,Uncategorized
2021-06-16,,KING SOOPERS #0129 ERIE CO Date 06/15/21 24445001166300480867865 Card 5089,23.3,,Posted,17833.12,Groceries
2021-06-15,,Tangerine - Lafayette Lafayette CO Date 06/14/21 24342851166017028695507 Card 5089,32.06,,Posted,17856.42,Restaurants
2021-06-15,,TYPE: USATAXPYMT ID: 3387702000 CO: IRS,2276.31,,Posted,17888.48,Federal Tax
2021-06-15,,TYPE: TaxPaymnt ID: T846000537 CO: Dept. of Revenue,373,,Posted,20164.79,State Tax
2021-06-15,,TYPE: DEPOSIT ID: C592126793 CO: MERCHANT BANKCD,0.52,,Posted,20537.79,Uncategorized
2021-06-15,,SPOTIFY 877-778-1161 NY Card 5089,10.84,,Posted,20538.31,Music
2021-06-14,2468,Check 2468,416.35,,Posted,20549.15,Check
2021-06-14,,KING SOOPERS #01 13632 COLORADO THORNTON CO Card 5089,28.74,,Posted,20965.5,Groceries
2021-06-14,,TYPE: XCELENERGY ID: 5840296600 CO: XCEL ENERGY-PSCO,180.92,,Posted,20994.24,Utilities
2021-06-14,,TYPE: DEPOSIT ID: C592126793 CO: MERCHANT BANKCD,0.52,,Posted,21175.16,Uncategorized
2021-06-14,,TYPE: COMB. DEP. ID: 7300604847 CO: 5/3 BANKCARD SYS,,176.8,Posted,21175.68,Income
2021-06-14,,TYPE: DEPOSIT ID: C592126793 CO: MERCHANT BANKCD,,157.99,Posted,20998.88,Income
2021-06-14,,TYPE: DEPOSIT ID: C592126793 CO: MERCHANT BANKCD,,123.91,Posted,20840.89,Income
2021-06-14,,TYPE: COMB. DEP. ID: 7300604847 CO: 5/3 BANKCARD SYS,,54.24,Posted,20716.98,Income
2021-06-13,,ABC*Anytime Fitness 888-8279262 CO Card 5089,45,,Posted,20662.74,Gym
2021-06-11,,Microsoft 1 Microsoft Way Redmon WA Card 5089,69.99,,Posted,20707.74,Electronics &amp; Software
2021-06-11,,TYPE: DEPOSIT ID: C592126793 CO: MERCHANT BANKCD,,299.7,Posted,20777.73,Income
2021-06-11,,TYPE: COMB. DEP. ID: 7300604847 CO: 5/3 BANKCARD SYS,,54.24,Posted,20478.03,Income
2021-06-10,,CEN*CENTURY MA 800-626-2787 OK Date 06/10/21 24692161161100394847970 Card 5089,67.8,,Posted,20423.79,Shopping
2021-06-10,,TYPE: DEPOSIT ID: C592126793 CO: MERCHANT BANKCD,1.04,,Posted,20491.59,Uncategorized
2021-06-10,,TYPE: Settlement ID: 9000904746 CO: VISION QUEST MAR,,429,Posted,20492.63,Uncategorized
2021-06-10,,TYPE: COMB. DEP. ID: 7300604847 CO: 5/3 BANKCARD SYS,,49,Posted,20063.63,Income
2021-06-10,,SMORE.COM WWW.SMORE.COM PA Card 5089,29,,Posted,20014.63,Electronics &amp; Software
2021-06-09,,Deposit Link24 T:0587G1NMLS1-01,,159,Posted,20043.63,Transfer
2021-06-09,,TYPE: Rent ID: 116943300A CO: Amterre Lincoln,5182.49,,Posted,19884.63,Transfer
2021-06-09,,TYPE: DEPOSIT ID: C592126793 CO: MERCHANT BANKCD,,295.25,Posted,25067.12,Income
2021-06-09,,TYPE: Settlement ID: 9000904746 CO: VISION QUEST MAR,,145,Posted,24771.87,Uncategorized
2021-06-08,,CEN*CENTURY MA 800-626-2787 OK Date 06/08/21 24692161159100716191010 Card 5089,213.73,,Posted,24626.87,Shopping
2021-06-08,,TYPE: BILLNG ID: 7300604847 CO: VANTIV_INTG_PYMT,268.85,,Posted,24840.6,Home
2021-06-08,,TYPE: DEPOSIT ID: C592126793 CO: MERCHANT BANKCD,,402.63,Posted,25109.45,Income
2021-06-07,2466,Check 2466,1283.8,,Posted,24706.82,Check
2021-06-07,,Tangerine - Lafayette Lafayette CO Date 06/04/21 24342851157017032803288 Card 5089,50.14,,Posted,25990.62,Restaurants
2021-06-07,,TYPE: DEPOSIT ID: C592126793 CO: MERCHANT BANKCD,,678.74,Posted,26040.76,Income
2021-06-07,,TYPE: COMB. DEP. ID: 7300604847 CO: 5/3 BANKCARD SYS,,663.63,Posted,25362.02,Income
2021-06-07,,TYPE: Settlement ID: 9000904746 CO: VISION QUEST MAR,,397,Posted,24698.39,Uncategorized
2021-06-07,,TYPE: DEPOSIT ID: C592126793 CO: MERCHANT BANKCD,,304.83,Posted,24301.39,Income
2021-06-07,,TYPE: DEPOSIT ID: C592126793 CO: MERCHANT BANKCD,,136.23,Posted,23996.56,Income
2021-06-04,,Check Received 60.00 Check Received 60.00 Check Received 60.00Check Received 50.00Check Received 225.00Check Received 50.00,,505,Posted,23860.33,Income
2021-06-04,,Deposit,,620,Posted,23355.33,Income
2021-06-04,,TYPE: DEPOSIT ID: C592126793 CO: MERCHANT BANKCD,,424.48,Posted,22735.33,Income
2021-06-04,,TYPE: Settlement ID: 9000904746 CO: VISION QUEST MAR,,130.5,Posted,22310.85,Uncategorized
2021-06-03,,TYPE: DEPOSIT ID: C592126793 CO: MERCHANT BANKCD,68.78,,Posted,22180.35,Uncategorized
2021-06-02,,ASIAN WORLD OF MARTIAL AR 800-3452962 PA Date 06/02/21 24639231153900010901706 Card 5089,34.05,,Posted,22249.13,Food &amp; Dining
2021-06-02,,TYPE: DEPOSIT ID: C592126793 CO: MERCHANT BANKCD,,1086.76,Posted,22283.18,Income
2021-06-02,,CALENDLY HTTPSCALENDLY GA Card 5089,15,,Posted,21196.42,Electronics &amp; Software
2021-06-01,,TYPE: COMB. DEP. ID: 7300604847 CO: 5/3 BANKCARD SYS,,365.53,Posted,21211.42,Income
2021-06-01,,TYPE: COMB. DEP. ID: 7300604847 CO: 5/3 BANKCARD SYS,,98,Posted,20845.89,Income
2021-06-01,,TYPE: COMB. DEP. ID: 7300604847 CO: 5/3 BANKCARD SYS,,49,Posted,20747.89,Income
2021-06-01,,TYPE: QUICKBOOKS ID: 1722616679 CO: INTUIT PAYROLL S,6482,,Posted,20698.89,Business Services
2021-06-01,,TYPE: DEPOSIT ID: C592126793 CO: MERCHANT BANKCD,1.57,,Posted,27180.89,Uncategorized
2021-06-01,,TYPE: DEPOSIT ID: C592126793 CO: MERCHANT BANKCD,,684.53,Posted,27182.46,Income
2021-06-01,,TYPE: Settlement ID: 9000904746 CO: VISION QUEST MAR,,155,Posted,26497.93,Uncategorized
2021-05-31,,Withdrawal Acct Svc Charge,10,,Posted,26342.93,Uncategorized
2021-05-29,,Intuit *QuickBooks 833-830-9255 CA Date 05/29/21 24692161149100846064882 Card 5089,199.99,,Posted,26352.93,Business Services
2021-05-29,,CORALTREE-QBOX 408-448-7269 CA Date 05/29/21 24492151149719408823337 Card 5089,12,,Posted,26552.92,Charity
2021-05-28,,TYPE: EPS ID: H03900 CO: JACK HENRY &amp; ASC,4.92,,Posted,26564.92,Uncategorized
2021-05-28,,TYPE: DEPOSIT ID: C592126793 CO: MERCHANT BANKCD,,701.67,Posted,26569.84,Income
2021-05-28,,TYPE: COMB. DEP. ID: 7300604847 CO: 5/3 BANKCARD SYS,,116.01,Posted,25868.17,Income
2021-05-27,,CANVA* 03068-17335556 HTTPSCANVA.CO DE Card 5089,12.99,,Posted,25752.16,Shopping
2021-05-27,,COMCAST CABLE COMM 800-COMCAST CO Card 5089,191.12,,Posted,25765.15,Utilities
2021-05-27,,TYPE: TRANSFER ID: PAYPALSD11 CO: PAYPAL,,2657.65,Posted,25956.27,Transfer
2021-05-27,,TYPE: DEPOSIT ID: C592126793 CO: MERCHANT BANKCD,,532.98,Posted,23298.62,Income
2021-05-27,,TYPE: COMB. DEP. ID: 7300604847 CO: 5/3 BANKCARD SYS,,49,Posted,22765.64,Income
2021-05-27,,MORRELL PRINTING SOLUTION 303-6654210 CO Date 05/26/21 24559301146900017100176 Card 5089,30.08,,Posted,22716.64,Printing
2021-05-27,,ZOOM.US 888-799-9666 WWW.ZOOM.US CA Card 5089,32.53,,Posted,22746.72,Business Services
2021-05-26,,TYPE: VERIFYBANK ID: PAYPALRD33 CO: PAYPAL,0.29,,Posted,22779.25,Transfer
2021-05-26,,TYPE: DEPOSIT ID: C592126793 CO: MERCHANT BANKCD,,518.96,Posted,22779.54,Income
2021-05-26,,TYPE: VERIFYBANK ID: PAYPALRD33 CO: PAYPAL,,0.15,Posted,22260.58,Transfer
2021-05-26,,TYPE: VERIFYBANK ID: PAYPALRD33 CO: PAYPAL,,0.14,Posted,22260.43,Transfer
2021-05-26,,Audible*2R0GF5KA1 Amzn.com/bill NJ Date 05/25/21 24692161145100923854753 Card 5089,16.22,,Posted,22260.29,Books
2021-05-25,,TYPE: PAYMENT ID: CITICARDAP CO: CITI AUTOPAY,271.41,,Posted,22276.51,Credit Card Payment
2021-05-25,,TYPE: DEPOSIT ID: C592126793 CO: MERCHANT BANKCD,,82.26,Posted,22547.92,Income
2021-05-24,,TYPE: DEPOSIT ID: C592126793 CO: MERCHANT BANKCD,2.09,,Posted,22465.66,Uncategorized
2021-05-24,,TYPE: DEPOSIT ID: C592126793 CO: MERCHANT BANKCD,0.52,,Posted,22467.75,Uncategorized
2021-05-24,,TYPE: DEPOSIT ID: C592126793 CO: MERCHANT BANKCD,,439.01,Posted,22468.27,Income
2021-05-24,,TYPE: COMB. DEP. ID: 7300604847 CO: 5/3 BANKCARD SYS,,19.52,Posted,22029.26,Income
2021-05-21,,TYPE: USATAXPYMT ID: 3387702000 CO: IRS,389.18,,Posted,22009.74,Federal Tax
2021-05-21,,AMAZON.COM SEATTLE WA Card 5089,26.05,,Posted,22398.92,Shopping
2021-05-21,,CEN*CENTURY MA 800-626-2787 OK Date 05/21/21 24692161141100648071216 Card 5089,18.39,,Posted,22424.97,Shopping
2021-05-21,,TYPE: DEPOSIT ID: C592126793 CO: MERCHANT BANKCD,,809,Posted,22443.36,Income
2021-05-21,,TYPE: Settlement ID: 9000904746 CO: VISION QUEST MAR,,445,Posted,21634.36,Uncategorized
2021-05-21,,ABC*Anytime Fitness 888-8279262 CO Card 5089,32.3,,Posted,21189.36,Gym
2021-05-20,,TYPE: TaxPaymnt ID: T846000537 CO: Dept. of Revenue,27.28,,Posted,21221.66,State Tax
2021-05-20,,TYPE: DEPOSIT ID: C592126793 CO: MERCHANT BANKCD,0.52,,Posted,21248.94,Uncategorized
2021-05-20,,TYPE: Settlement ID: 9000904746 CO: VISION QUEST MAR,,447,Posted,21249.46,Uncategorized
2021-05-19,,TYPE: Settlement ID: 9000904746 CO: VISION QUEST MAR,,310,Posted,20802.46,Uncategorized
2021-05-19,,TYPE: DEPOSIT ID: C592126793 CO: MERCHANT BANKCD,,286.73,Posted,20492.46,Income
2021-05-18,,TYPE: Settlement ID: 9000904746 CO: VISION QUEST MAR,,304,Posted,20205.73,Uncategorized
2021-05-18,,TYPE: DEPOSIT ID: C592126793 CO: MERCHANT BANKCD,,138.84,Posted,19901.73,Income
2021-05-17,,TYPE: USATAXPYMT ID: 3387702000 CO: IRS,2049.01,,Posted,19762.89,Federal Tax
2021-05-17,,TYPE: TaxPaymnt ID: T846000537 CO: Dept. of Revenue,337,,Posted,21811.9,State Tax
2021-05-17,,TYPE: DEPOSIT ID: C592126793 CO: MERCHANT BANKCD,4.7,,Posted,22148.9,Uncategorized
2021-05-17,,TYPE: DEPOSIT ID: C592126793 CO: MERCHANT BANKCD,,943.13,Posted,22153.6,Income
2021-05-17,,TYPE: DEPOSIT ID: C592126793 CO: MERCHANT BANKCD,,429.36,Posted,21210.47,Income
2021-05-17,,TYPE: COMB. DEP. ID: 7300604847 CO: 5/3 BANKCARD SYS,,86.79,Posted,20781.11,Income
2021-05-17,,TYPE: COMB. DEP. ID: 7300604847 CO: 5/3 BANKCARD SYS,,86.79,Posted,20694.32,Income
2021-05-16,,KICKSITE 913-681-9949 KS Date 05/16/21 24055221136200832505191 Card 5089,149,,Posted,20607.53,Charity
2021-05-15,,CEN*CENTURY MA 800-626-2787 OK Date 05/15/21 24692161135100259809100 Card 5089,21.03,,Posted,20756.53,Shopping
2021-05-15,,Spotify USA 877-7781161 NY Card 5089,10.84,,Posted,20777.56,Music
2021-05-14,,TYPE: XCELENERGY ID: 5840296600 CO: XCEL ENERGY-PSCO,261.05,,Posted,20788.4,Utilities
2021-05-14,,TYPE: DEPOSIT ID: C592126793 CO: MERCHANT BANKCD,,299.7,Posted,21049.45,Income
2021-05-14,,TYPE: COMB. DEP. ID: 7300604847 CO: 5/3 BANKCARD SYS,,236.42,Posted,20749.75,Income
2021-05-14,,TYPE: Settlement ID: 9000904746 CO: VISION QUEST MAR,,145,Posted,20513.33,Uncategorized
2021-05-14,,Tangerine - Lafayette Lafayette CO Date 05/12/21 24342851133017028681291 Card 5089,75,,Posted,20368.33,Uncategorized
2021-05-13,,TYPE: DEPOSIT ID: C592126793 CO: MERCHANT BANKCD,1.57,,Posted,20443.33,Uncategorized
2021-05-13,,ABC*Anytime Fitness 888-8279262 CO Card 5089,45,,Posted,20444.9,Gym
2021-05-12,,TYPE: PURCHASE ID: 9000098054 CO: City of Lafayett,19.26,,Posted,20489.9,Utilities
2021-05-12,,TYPE: DEPOSIT ID: C592126793 CO: MERCHANT BANKCD,,124.43,Posted,20509.16,Income
2021-05-11,,TYPE: DEPOSIT ID: C592126793 CO: MERCHANT BANKCD,,454.81,Posted,20384.73,Income
2021-05-11,,TYPE: Settlement ID: 9000904746 CO: VISION QUEST MAR,,429,Posted,19929.92,Uncategorized
2021-05-10,,TYPE: DEPOSIT ID: C592126793 CO: MERCHANT BANKCD,1.57,,Posted,19500.92,Uncategorized
2021-05-10,,TYPE: COMB. DEP. ID: 7300604847 CO: 5/3 BANKCARD SYS,,439.79,Posted,19502.49,Income
2021-05-10,,TYPE: DEPOSIT ID: C592126793 CO: MERCHANT BANKCD,,402.63,Posted,19062.7,Income
2021-05-10,,TYPE: DEPOSIT ID: C592126793 CO: MERCHANT BANKCD,,147.37,Posted,18660.07,Income
2021-05-10,,SMORE.COM WWW.SMORE.COM PA Card 5089,29,,Posted,18512.7,Electronics &amp; Software
2021-05-07,,THE HOME DEPOT 1548 16420 WASHINGTON STREET BROOMFIELD CO Card 5089,46.85,,Posted,18541.7,Home Improvement
2021-05-07,,TYPE: Rent ID: 116943300A CO: Amterre Lincoln,5310.73,,Posted,18588.55,Transfer
2021-05-07,,TYPE: DEPOSIT ID: C592126793 CO: MERCHANT BANKCD,2.61,,Posted,23899.28,Uncategorized
2021-05-07,,TYPE: Settlement ID: 9000904746 CO: VISION QUEST MAR,,145,Posted,23901.89,Uncategorized
2021-05-06,,THE HOME DEPOT 1548 16420 WASHINGTON STREET BROOMFIELD CO Card 5089,58.52,,Posted,23756.89,Home Improvement
2021-05-06,,TYPE: DEPOSIT ID: C592126793 CO: MERCHANT BANKCD,,679.79,Posted,23815.41,Income
2021-05-06,,TYPE: Settlement ID: 9000904746 CO: VISION QUEST MAR,,232,Posted,23135.62,Uncategorized
2021-05-05,,TYPE: BILLNG ID: 7300604847 CO: VANTIV_INTG_PYMT,248.23,,Posted,22903.62,Home
2021-05-05,,TYPE: DEPOSIT ID: C592126793 CO: MERCHANT BANKCD,1.57,,Posted,23151.85,Uncategorized
2021-05-04,,TYPE: DEPOSIT ID: C592126793 CO: MERCHANT BANKCD,,425,Posted,23153.42,Income
2021-05-04,,TYPE: Settlement ID: 9000904746 CO: VISION QUEST MAR,,130.5,Posted,22728.42,Uncategorized
2021-05-03,,TYPE: PRM PYMT ID: 9437678001 CO: COLO UI ER SV,202.2,,Posted,22597.92,Uncategorized
2021-05-03,,TYPE: DEPOSIT ID: C592126793 CO: MERCHANT BANKCD,60.46,,Posted,22800.12,Uncategorized
2021-05-03,,TYPE: DEPOSIT ID: C592126793 CO: MERCHANT BANKCD,,947.93,Posted,22860.58,Income
2021-05-03,,TYPE: COMB. DEP. ID: 7300604847 CO: 5/3 BANKCARD SYS,,224.88,Posted,21912.65,Income
2021-05-03,,TYPE: COMB. DEP. ID: 7300604847 CO: 5/3 BANKCARD SYS,,58.57,Posted,21687.77,Income
2021-05-03,,TYPE: COMB. DEP. ID: 7300604847 CO: 5/3 BANKCARD SYS,,36.87,Posted,21629.2,Income
2021-05-01,,CALENDLY HTTPSCALENDLY GA Card 5089,15,,Posted,21592.33,Electronics &amp; Software
2021-04-30,,Withdrawal Acct Svc Charge,10,,Posted,21607.33,Uncategorized
2021-04-30,,TYPE: QUICKBOOKS ID: 1722616679 CO: INTUIT PAYROLL S,6171.84,,Posted,21617.33,Business Services
2021-04-30,,TYPE: DEPOSIT ID: C592126793 CO: MERCHANT BANKCD,1.04,,Posted,27789.17,Uncategorized
2021-04-30,,TYPE: Settlement ID: 9000904746 CO: VISION QUEST MAR,,155,Posted,27790.21,Uncategorized
2021-04-30,,TYPE: COMB. DEP. ID: 7300604847 CO: 5/3 BANKCARD SYS,,54.24,Posted,27635.21,Income
2021-04-29,,CORALTREE-QBOX 408-448-7269 CA Date 04/29/21 24492151119713884167208 Card 5089,12,,Posted,27580.97,Charity
2021-04-29,,TYPE: DEPOSIT ID: C592126793 CO: MERCHANT BANKCD,,527.06,Posted,27592.97,Income
2021-04-28,,TYPE: DEPOSIT ID: C592126793 CO: MERCHANT BANKCD,,136.75,Posted,27065.91,Income
2021-04-27,,CEN*CENTURY MA 800-626-2787 OK Date 04/27/21 24692161117100772281896 Card 5089,46.84,,Posted,26929.16,Shopping
2021-04-27,,TYPE: DEPOSIT ID: C592126793 CO: MERCHANT BANKCD,,534.02,Posted,26976,Income
2021-04-26,,ASIAN WORLD OF MARTIAL AR 800-3452962 PA Date 04/26/21 24639231116900016200992 Card 5089,692.27,,Posted,26441.98,Food &amp; Dining
2021-04-26,,ZOOM.US 888-799-9666 WWW.ZOOM.US CA Date 04/26/21 24011341116000051058846 Card 5089,32.53,,Posted,27134.25,Business Services
2021-04-26,,TYPE: DEPOSIT ID: C592126793 CO: MERCHANT BANKCD,1.04,,Posted,27166.78,Uncategorized
2021-04-26,,TYPE: DEPOSIT ID: C592126793 CO: MERCHANT BANKCD,,439.01,Posted,27167.82,Income
2021-04-26,,TYPE: DEPOSIT ID: C592126793 CO: MERCHANT BANKCD,,287.25,Posted,26728.81,Income
2021-04-26,,TYPE: COMB. DEP. ID: 7300604847 CO: 5/3 BANKCARD SYS,,60,Posted,26441.56,Income
2021-04-25,,Audible*SF2BJ8NM3 Amzn.com/bill NJ Date 04/25/21 24692161115100643590774 Card 5089,16.22,,Posted,26381.56,Books
2021-04-24,,COMCAST CABLE COMM 800-COMCAST CO Card 5089,190.98,,Posted,26397.78,Utilities
2021-04-23,,TYPE: PAYMENT ID: CITICARDAP CO: CITI AUTOPAY,327.59,,Posted,26588.76,Credit Card Payment
2021-04-23,,TYPE: DEPOSIT ID: C592126793 CO: MERCHANT BANKCD,0.52,,Posted,26916.35,Uncategorized
2021-04-22,,TYPE: DEPOSIT ID: C592126793 CO: MERCHANT BANKCD,,136.75,Posted,26916.87,Income
2021-04-22,,TYPE: COMB. DEP. ID: 7300604847 CO: 5/3 BANKCARD SYS,,58.57,Posted,26780.12,Income
2021-04-21,,TYPE: DEPOSIT ID: C592126793 CO: MERCHANT BANKCD,,546.25,Posted,26721.55,Income
2021-04-21,,ABC*Anytime Fitness 888-8279262 CO Card 5089,32.3,,Posted,26175.3,Gym
2021-04-20,,CEN*CENTURY MA 800-626-2787 OK Date 04/20/21 24692161110100583388317 Card 5089,531.5,,Posted,26207.6,Shopping
2021-04-20,,TYPE: TaxPaymnt ID: T846000537 CO: Dept. of Revenue,11.87,,Posted,26739.1,State Tax
2021-04-20,,TYPE: PURCHASE ID: 9000098054 CO: City of Lafayett,8.38,,Posted,26750.97,Utilities
2021-04-20,,TYPE: DEPOSIT ID: C592126793 CO: MERCHANT BANKCD,0.52,,Posted,26759.35,Uncategorized
2021-04-19,,TYPE: 8002338483 ID: 1043575881 CO: Affiliated SV9T,,6656.54,Posted,26759.87,Paycheck
2021-04-19,,TYPE: DEPOSIT ID: C592126793 CO: MERCHANT BANKCD,,138.84,Posted,20103.33,Income
2021-04-19,,TYPE: DEPOSIT ID: C592126793 CO: MERCHANT BANKCD,,138.84,Posted,19964.49,Income
2021-04-19,,TYPE: DEPOSIT ID: C592126793 CO: MERCHANT BANKCD,,137.8,Posted,19825.65,Income
2021-04-19,,TYPE: COMB. DEP. ID: 7300604847 CO: 5/3 BANKCARD SYS,,16.8,Posted,19687.85,Income
2021-04-17,,CEN*CENTURY MA 800-626-2787 OK Date 04/17/21 24692161107100497871916 Card 5089,178.34,,Posted,19671.05,Shopping
2021-04-17,,KICKSITE 913-681-9949 KS Date 04/16/21 24055221106200832500271 Card 5089,149,,Posted,19849.39,Charity
2021-04-16,,ABC*Anytime Fitness 888-8279262 CO Card 5089,22,,Posted,19998.39,Gym
2021-04-15,,TYPE: USATAXPYMT ID: 3387702000 CO: IRS,2392.19,,Posted,20020.39,Federal Tax
2021-04-15,,TYPE: TaxPaymnt ID: T846000537 CO: Dept. of Revenue,393,,Posted,22412.58,State Tax
2021-04-15,,TYPE: XCELENERGY ID: 5840296600 CO: XCEL ENERGY-PSCO,288.31,,Posted,22805.58,Utilities
2021-04-15,,Spotify USA 877-7781161 NY Card 5089,10.84,,Posted,23093.89,Music
2021-04-13,,TYPE: COMB. DEP. ID: 7300604847 CO: 5/3 BANKCARD SYS,,108.48,Posted,23104.73,Income
2021-04-13,,ABC*Anytime Fitness 888-8279262 CO Card 5089,45,,Posted,22996.25,Gym
2021-04-12,,TYPE: COMB. DEP. ID: 7300604847 CO: 5/3 BANKCARD SYS,,311.28,Posted,23041.25,Income
2021-04-12,,TYPE: COMB. DEP. ID: 7300604847 CO: 5/3 BANKCARD SYS,,155,Posted,22729.97,Income
2021-04-12,,TYPE: COMB. DEP. ID: 7300604847 CO: 5/3 BANKCARD SYS,,108.48,Posted,22574.97,Income
2021-04-11,,SMORE.COM WWW.SMORE.COM PA Card 5089,29,,Posted,22466.49,Electronics &amp; Software
2021-04-09,,TYPE: Rent ID: 116943300A CO: Amterre Lincoln,5033.94,,Posted,22495.49,Transfer
2021-04-09,,TYPE: COMB. DEP. ID: 7300604847 CO: 5/3 BANKCARD SYS,,54.24,Posted,27529.43,Income
2021-04-06,,CEN*CENTURY MA 800-626-2787 OK Date 04/06/21 24692161096100300410889 Card 5089,19.05,,Posted,27475.19,Shopping
2021-04-06,,TYPE: BILLNG ID: 7300604847 CO: VANTIV_INTG_PYMT,178.74,,Posted,27494.24,Home
2021-04-05,2465,Check 2465,300,,Posted,27672.98,Check
2021-04-05,,TYPE: USATAXPYMT ID: 3387702000 CO: IRS,1993.75,,Posted,27972.98,Federal Tax
2021-04-05,,TYPE: USATAXPYMT ID: 3387702000 CO: IRS,1898.09,,Posted,29966.73,Federal Tax
2021-04-05,,TYPE: TaxPaymnt ID: T846000537 CO: Dept. of Revenue,337,,Posted,31864.82,State Tax
2021-04-05,,TYPE: TaxPaymnt ID: T846000537 CO: Dept. of Revenue,327,,Posted,32201.82,State Tax
2021-04-05,,TYPE: DEPOSIT ID: C592126793 CO: MERCHANT BANKCD,58.96,,Posted,32528.82,Uncategorized
2021-04-05,,TYPE: 8002338483 ID: 1043575881 CO: Affiliated SV9T,,3609.92,Posted,32587.78,Paycheck
2021-04-05,,TYPE: COMB. DEP. ID: 7300604847 CO: 5/3 BANKCARD SYS,,1765,Posted,28977.86,Income
2021-04-05,,TYPE: COMB. DEP. ID: 7300604847 CO: 5/3 BANKCARD SYS,,110,Posted,27212.86,Income
2021-04-01,,CALENDLY HTTPSCALENDLY GA Card 5089,15,,Posted,27102.86,Electronics &amp; Software
2021-04-01,,THE BOLD LOOK 305-687-8725 FL Date 03/31/21 24493981090207724100349 Card 5089,337.68,,Posted,27117.86,Uncategorized
2021-03-31,,Withdrawal Acct Svc Charge,10,,Posted,27455.54,Uncategorized
2021-03-31,,THE BOLD LOOK 305-687-8725 FL Date 03/30/21 24493981089207724000138 Card 5089,411.71,,Posted,27465.54,Uncategorized
2021-03-31,,TYPE: QUICKBOOKS ID: 1722616679 CO: INTUIT PAYROLL S,5497.42,,Posted,27877.25,Business Services
2021-03-30,,PINNACOL ASSURANCE 303-361-4000 CO Date 03/29/21 24270761088602385290042 Card 5089,528,,Posted,33374.67,Uncategorized
2021-03-29,,CORALTREE-QBOX 408-448-7269 CA Date 03/29/21 24492151088719417410798 Card 5089,12,,Posted,33902.67,Charity
2021-03-29,,CALENDLY HTTPSCALENDLY GA Date 03/28/21 24492151087637043953299 Card 5089,48,,Posted,33914.67,Electronics &amp; Software
2021-03-29,,CALENDLY HTTPSCALENDLY GA Date 03/28/21 24492151087637043881573 Card 5089,96,,Posted,33962.67,Electronics &amp; Software
2021-03-27,,ZOOM.US 888-799-9666 WWW.ZOOM.US CA Card 5089,32.53,,Posted,34058.67,Business Services
2021-03-26,,Audible*6V4UV0G03 Amzn.com/bill NJ Date 03/25/21 24692161085100789012159 Card 5089,16.22,,Posted,34091.2,Books
2021-03-24,,COMCAST CABLE COMM 800-COMCAST CO Card 5089,190.98,,Posted,34107.42,Utilities
2021-03-23,,TYPE: PAYMENT ID: CITICARDAP CO: CITI AUTOPAY,292.79,,Posted,34298.4,Credit Card Payment
2021-03-22,,TYPE: COMB. DEP. ID: 7300604847 CO: 5/3 BANKCARD SYS,,54.24,Posted,34591.19,Income
2021-03-21,,ABC*Anytime Fitness 888-8279262 CO Card 5089,32.3,,Posted,34536.95,Gym
2021-03-19,,CEN*CENTURY MA 800-626-2787 OK Date 03/19/21 24692161078100879639639 Card 5089,3.83,,Posted,34569.25,Shopping
2021-03-19,,TYPE: TaxPaymnt ID: T846000537 CO: Dept. of Revenue,15.03,,Posted,34573.08,State Tax
2021-03-19,,TYPE: COMB. DEP. ID: 7300604847 CO: 5/3 BANKCARD SYS,,86.79,Posted,34588.11,Income
2021-03-18,,APPLE.COM/BILL 866-712-7753 CA Date 03/18/21 24692161077100936490951 Card 5089,14.99,,Posted,34501.32,Entertainment
2021-03-17,,TYPE: XCELENERGY ID: 5840296600 CO: XCEL ENERGY-PSCO,521.59,,Posted,34516.31,Utilities
2021-03-17,,TYPE: 8002338483 ID: 1043575881 CO: Affiliated SV9T,,6511.04,Posted,35037.9,Paycheck
2021-03-16,,KICKSITE 913-681-9949 KS Date 03/16/21 24055221075200832400289 Card 5089,149,,Posted,28526.86,Charity
2021-03-15,,TYPE: COMB. DEP. ID: 7300604847 CO: 5/3 BANKCARD SYS,,54.24,Posted,28675.86,Income
2021-03-14,,Spotify USA 877-7781161 NY Card 5089,10.84,,Posted,28621.62,Music
2021-03-13,,APPLE.COM/BILL 866-712-7753 CA Date 03/12/21 24692161072100204926707 Card 5089,24.97,,Posted,28632.46,Entertainment
2021-03-13,,ABC*Anytime Fitness 888-8279262 CO Card 5089,45,,Posted,28657.43,Gym
2021-03-12,,ASIAN WORLD OF MARTIAL AR 800-3452962 PA Date 03/12/21 24639231071900011700981 Card 5089,610.26,,Posted,28702.43,Food &amp; Dining
2021-03-12,,MORRELL PRINTING SOLUTION 303-6654210 CO Date 03/11/21 24559301070900011500207 Card 5089,27.95,,Posted,29312.69,Printing
2021-03-11,,CEN*CENTURY MA 800-626-2787 OK Date 03/11/21 24692161070100997859026 Card 5089,19.49,,Posted,29340.64,Shopping
2021-03-10,,SMORE.COM WWW.SMORE.COM PA Card 5089,29,,Posted,29360.13,Electronics &amp; Software
2021-03-10,,MORRELL PRINTING SOLUTION 303-6654210 CO Date 03/09/21 24559301068900011300057 Card 5089,73.23,,Posted,29389.13,Printing
2021-03-09,,TYPE: PURCHASE ID: 9000098054 CO: City of Lafayett,10.61,,Posted,29462.36,Utilities
2021-03-08,2463,Check 2463,1000,,Posted,29472.97,Check
2021-03-08,,DOLLAR TREE 555 W SOUTH BOULDER RD LAFAYETTE CO Card 5089,8.68,,Posted,30472.97,Shopping
2021-03-08,,TYPE: Rent ID: 116943300A CO: Amterre Lincoln,4776.8,,Posted,30481.65,Transfer
2021-03-05,,CEN*CENTURY MA 800-626-2787 OK Date 03/05/21 24692161064100773781012 Card 5089,3.83,,Posted,35258.45,Shopping
2021-03-05,,TYPE: BILLNG ID: 7300604847 CO: VANTIV_INTG_PYMT,287.59,,Posted,35262.28,Home
2021-03-04,,CEN*CENTURY MA 800-626-2787 OK Date 03/04/21 24692161063100011756611 Card 5089,5.85,,Posted,35549.87,Shopping
2021-03-02,,TYPE: QUICKBOOKS ID: 1722616679 CO: INTUIT PAYROLL S,6478.36,,Posted,35555.72,Business Services
2021-03-02,,TYPE: 8002338483 ID: 1043575881 CO: Affiliated SV9T,,2840.07,Posted,42034.08,Paycheck
2021-03-02,,PINNACOL ASSURANCE 303-361-4000 CO Date 03/01/21 24270761060602154401152 Card 5089,414,,Posted,39194.01,Uncategorized
2021-03-01,,CALENDLY HTTPSCALENDLY GA Date 02/28/21 24492151060637800260798 Card 5089,30,,Posted,39608.01,Electronics &amp; Software
2021-03-01,,CORALTREE-QBOX 408-448-7269 CA Date 03/01/21 24492151060715185699770 Card 5089,12,,Posted,39638.01,Charity
2021-03-01,,TYPE: COMB. DEP. ID: 7300604847 CO: 5/3 BANKCARD SYS,,3931.8,Posted,39650.01,Income
2021-02-28,,Withdrawal Acct Svc Charge,10,,Posted,35718.21,Uncategorized
2021-02-27,,CEN*CENTURY MA 800-626-2787 OK Date 02/27/21 24692161058100349057572 Card 5089,6.76,,Posted,35728.21,Shopping
2021-02-27,,ZOOM.US 888-799-9666 WWW.ZOOM.US CA Date 02/27/21 24011341058000013426735 Card 5089,32.53,,Posted,35734.97,Business Services
2021-02-26,,CEN*CENTURY MA 800-626-2787 OK Date 02/26/21 24692161057100284579920 Card 5089,5.86,,Posted,35767.5,Shopping
2021-02-25,,Audible*3274O8H33 Amzn.com/bill NJ Date 02/25/21 24692161056100829181571 Card 5089,16.22,,Posted,35773.36,Books
2021-02-25,,CEN*CENTURY MA 800-626-2787 OK Date 02/25/21 24692161056100570204390 Card 5089,2.93,,Posted,35789.58,Shopping
2021-02-24,,CEN*CENTURY MA 800-626-2787 OK Date 02/24/21 24692161055100863379892 Card 5089,16.2,,Posted,35792.51,Shopping
2021-02-24,,COMCAST CABLE COMM 800-COMCAST CO Card 5089,190.98,,Posted,35808.71,Utilities
2021-02-23,,CEN*CENTURY MA 800-626-2787 OK Date 02/23/21 24692161054100172074805 Card 5089,176.66,,Posted,35999.69,Shopping
2021-02-23,,TYPE: PAYMENT ID: CITICARDAP CO: CITI AUTOPAY,272.16,,Posted,36176.35,Credit Card Payment
2021-02-22,,TYPE: 6-BLP3500 ID: 1840837398 CO: COLORADO LOAN,,3500,Posted,36448.51,Transfer
2021-02-22,,TYPE: COMB. DEP. ID: 7300604847 CO: 5/3 BANKCARD SYS,,50,Posted,32948.51,Income
2021-02-22,,TYPE: COMB. DEP. ID: 7300604847 CO: 5/3 BANKCARD SYS,,49,Posted,32898.51,Income
2021-02-21,,ABC*Anytime Fitness 888-8279262 CO Card 5089,32.3,,Posted,32849.51,Gym
2021-02-19,,TYPE: TaxPaymnt ID: T846000537 CO: Dept. of Revenue,5.33,,Posted,32881.81,State Tax
2021-02-18,,TYPE: COMB. DEP. ID: 7300604847 CO: 5/3 BANKCARD SYS,,49,Posted,32887.14,Income
2021-02-17,,TYPE: PURCHASE ID: 9000098054 CO: City of Lafayett,3.77,,Posted,32838.14,Utilities
2021-02-17,,TYPE: 8002338483 ID: 1043575881 CO: Affiliated SV9T,,6744.47,Posted,32841.91,Paycheck
2021-02-16,,KICKSITE 913-681-9949 KS Date 02/16/21 24055221047200832600321 Card 5089,149,,Posted,26097.44,Charity
2021-02-16,,TYPE: XCELENERGY ID: 5840296600 CO: XCEL ENERGY-PSCO,443.46,,Posted,26246.44,Utilities
2021-02-16,,TYPE: COMB. DEP. ID: 7300604847 CO: 5/3 BANKCARD SYS,,54.24,Posted,26689.9,Income
2021-02-14,,Spotify USA 877-7781161 NY Card 5089,10.84,,Posted,26635.66,Music
2021-02-14,,KING SOOPERS #0129 ERIE CO Date 02/13/21 24445001044300436901527 Card 5089,16.37,,Posted,26646.5,Groceries
2021-02-13,,CEN*CENTURY MA 800-626-2787 OK Date 02/13/21 24692161044100871613096 Card 5089,11.7,,Posted,26662.87,Shopping
2021-02-13,,ABC*Anytime Fitness 888-8279262 CO Card 5089,45,,Posted,26674.57,Gym
2021-02-11,2462,Check 2462,1200,,Posted,26719.57,Check
2021-02-11,,TYPE: CASH DISB ID: 5264438761 CO: KABBAGE DIRECT,,22876,Posted,27919.57,Paycheck
2021-02-10,,CEN*CENTURY MA 800-626-2787 OK Date 02/10/21 24692161041100470853559 Card 5089,26.94,,Posted,5043.57,Shopping
2021-02-10,,TYPE: Rent ID: 116943300A CO: Amterre Lincoln,2929.49,,Posted,5070.51,Transfer
2021-02-10,,DOLLAR TREE LAFAYETTE CO Date 02/09/21 24445001041000684135900 Card 5089,3.25,,Posted,8000,Shopping
2021-02-09,,TYPE: COMB. DEP. ID: 7300604847 CO: 5/3 BANKCARD SYS,,225,Posted,8003.25,Income
2021-02-08,,TYPE: BILLNG ID: 7300604847 CO: VANTIV_INTG_PYMT,223.45,,Posted,7778.25,Home
2021-02-08,,TYPE: COMB. DEP. ID: 7300604847 CO: 5/3 BANKCARD SYS,,108.48,Posted,8001.7,Income
2021-02-05,,TYPE: COMB. DEP. ID: 7300604847 CO: 5/3 BANKCARD SYS,,33.61,Posted,7893.22,Income
2021-02-03,,TYPE: PRM PYMT ID: 9437678001 CO: COLO UI ER SV,45.61,,Posted,7859.61,Uncategorized
2021-02-02,,TYPE: 8002338483 ID: 1043575881 CO: Affiliated SV9T,,3444.99,Posted,7905.22,Paycheck
2021-02-01,,TYPE: QUICKBOOKS ID: 1722616679 CO: INTUIT PAYROLL S,4718.61,,Posted,4460.23,Business Services
2021-02-01,,TYPE: USATAXPYMT ID: 3387702000 CO: IRS,175.63,,Posted,9178.84,Federal Tax
2021-02-01,,TYPE: COMB. DEP. ID: 7300604847 CO: 5/3 BANKCARD SYS,,98,Posted,9354.47,Income
2021-02-01,,TYPE: COMB. DEP. ID: 7300604847 CO: 5/3 BANKCARD SYS,,50,Posted,9256.47,Income
2021-02-01,,PINNACOL ASSURANCE 303-361-4000 CO Date 01/31/21 24270761031602056688019 Card 5089,414,,Posted,9206.47,Uncategorized
2021-01-31,,Withdrawal Acct Svc Charge,10,,Posted,9620.47,Uncategorized
2021-01-29,,CORALTREE-QBOX 408-448-7269 CA Date 01/29/21 24492151029745928415739 Card 5089,12,,Posted,9630.47,Charity
2021-01-28,,TYPE: COMB. DEP. ID: 7300604847 CO: 5/3 BANKCARD SYS,,49,Posted,9642.47,Income
2021-01-27,,CEN*CENTURY MA 800-626-2787 OK Date 01/27/21 24692161027100595406687 Card 5089,26.97,,Posted,9593.47,Shopping
2021-01-27,,ZOOM.US 888-799-9666 WWW.ZOOM.US CA Card 5089,32.53,,Posted,9620.44,Business Services
2021-01-25,,Audible*AR4F183O3 Amzn.com/bill NJ Date 01/25/21 24692161025100469265781 Card 5089,16.22,,Posted,9652.97,Books
2021-01-25,,TYPE: PAYMENT ID: CITICARDAP CO: CITI AUTOPAY,173.82,,Posted,9669.19,Credit Card Payment
2021-01-25,,TYPE: COMB. DEP. ID: 7300604847 CO: 5/3 BANKCARD SYS,,900,Posted,9843.01,Income
2021-01-24,,COMCAST CABLE COMM 800-COMCAST CO Card 5089,190.63,,Posted,8943.01,Utilities
2021-01-21,,ABC*Anytime Fitness 888-8279262 CO Card 5089,32.3,,Posted,9133.64,Gym
2021-01-20,,CEN*CENTURY MA 800-626-2787 OK Date 01/20/21 24692161020100859736883 Card 5089,2.93,,Posted,9165.94,Shopping
2021-01-20,,TYPE: TaxPaymnt ID: T846000537 CO: Dept. of Revenue,2.34,,Posted,9168.87,State Tax
2021-01-20,,TYPE: 8002338483 ID: 1043575881 CO: Affiliated SV9T,,6935.88,Posted,9171.21,Paycheck
2021-01-19,,TYPE: PURCHASE ID: 9000098054 CO: City of Lafayett,1.66,,Posted,2235.33,Utilities
2021-01-16,,KICKSITE 913-681-9949 KS Date 01/16/21 24055221016200832600369 Card 5089,149,,Posted,2236.99,Charity
2021-01-15,,CEN*CENTURY MA 800-626-2787 OK Date 01/15/21 24692161015100467355289 Card 5089,8.78,,Posted,2385.99,Shopping
2021-01-15,,TYPE: USATAXPYMT ID: 3387702000 CO: IRS,2238.25,,Posted,2394.77,Federal Tax
2021-01-15,,TYPE: TaxPaymnt ID: T846000537 CO: Dept. of Revenue,379,,Posted,4633.02,State Tax
2021-01-15,,TYPE: COMB. DEP. ID: 7300604847 CO: 5/3 BANKCARD SYS,,49,Posted,5012.02,Income
2021-01-14,,Spotify USA 877-7781161 NY Card 5089,10.84,,Posted,4963.02,Music
2021-01-14,,TYPE: XCELENERGY ID: 5840296600 CO: XCEL ENERGY-PSCO,430.41,,Posted,4973.86,Utilities
2021-01-13,,CEN*CENTURY MA 800-626-2787 OK Date 01/13/21 24692161013100082701802 Card 5089,137.62,,Posted,5404.27,Shopping
2021-01-13,,ABC*Anytime Fitness 888-8279262 CO Card 5089,45,,Posted,5541.89,Gym
2021-01-11,,TYPE: COMB. DEP. ID: 7300604847 CO: 5/3 BANKCARD SYS,,450,Posted,5586.89,Income
2021-01-11,,TYPE: COMB. DEP. ID: 7300604847 CO: 5/3 BANKCARD SYS,,241.8,Posted,5136.89,Income
2021-01-07,,TYPE: COMB. DEP. ID: 7300604847 CO: 5/3 BANKCARD SYS,,35.79,Posted,4895.09,Income
2021-01-05,,TYPE: Rent ID: 116943300A CO: Amterre Lincoln,2877.5,,Posted,4859.3,Transfer
2021-01-05,,TYPE: BILLNG ID: 7300604847 CO: VANTIV_INTG_PYMT,403.58,,Posted,7736.8,Home
2021-01-05,,TYPE: 8002338483 ID: 1043575881 CO: Affiliated SV9T,,3772.09,Posted,8140.38,Paycheck
